一	keeeee
是	sieioo
不	bpoooo
了	lziiii
在	zpeiee
有	kpiaee
人	rhoooo
这	vfoaoo
上	sreeee
大	dpoooo
的	dhuaoo
来	luoooo
和	hliaee
我	wloooo
个	ghiiii
中	veiiii
地	dnaiaa
为	wgoooo
他	thaiaa
生	sleeee
要	kyauee
们	mhoiaa
以	kxuooo
到	diiiii
国	geeeoo
时	sieioo
就	jfeuoo
出	cziiii
说	sdouia
会	hheeao
也	kzaaaa
子	zzeeee
学	xsaiee
发	fnaooo
着	vgiaee
对	dxeioo
作	zhueee
能	nxuaua
可	yyiaee
于	koiiii
成	cpoooo
用	kkiiii
过	gyoaoo
动	doauuu
主	vfeeee
下	xyoooo
而	rpiiii
年	nliiii
分	fjauuu
得	dmiaee
家	jseuoo
种	cliaii
里	leeeee
多	dkuaoo
经	jcaoei
自	zheeee
现	xoiaua
同	teeiae
后	hmiaee
产	cfuuuu
方	ffuuuu
工	gyeeee
行	hmeeii
面	mpeeee
那	nbaiii
小	xtoooo
所	smuuii
起	qnaeaa
去	qnaooo
之	vdoooo
都	dyaiii
然	rkoooo
理	loiaee
进	jooaoo
体	theiee
还	hpoaoo
定	dseioo
实	ssoooo
如	rniaee
么	mkoooo
物	wluauu
法	fteiao
你	nhuaiu
好	hnaiee
性	xsueee
民	mbaaaa
从	chuooo
天	tooooo
化	hhuaaa
等	dleiei
力	lnuuuu
本	byeeee
长	cloooo
心	xdoooo
把	buaiaa
部	bfaiii
义	kgoooo
样	kbouee
事	syiiii
看	yuiaee
业	kqeeee
当	dwaeee
因	keeuoo
高	gfiaia
十	syiiii
开	yoiiii
些	sreeee
社	sdeiee
前	qgiaii
又	kxoooo
它	tsuaaa
水	stoooo
其	jyuooo
没	mtuaao
想	xboaoo
意	kfoaoo
三	soeeee
只	vjuooo
重	cleeee
点	droooo
与	kieeee
使	sheioo
但	dhiaee
度	dfaooo
由	keeeee
道	dgoaoo
全	qheeee
制	vliiii
明	miuaee
相	xbiaee
两	lyoooo
情	qseeia
外	wkiooo
间	jaiaee
二	roeeee
关	ggeeoo
活	htueia
正	vyeeee
合	ghiaee
者	vyiaee
形	xouuuu
应	kfooee
头	tseuoo
无	moaaaa
量	liiaee
表	bouaoo
象	xkiaoo
气	qlaaaa
文	wfoooo
展	vbeioo
系	juaaiu
代	dheaoo
加	jniaee
各	gkiaee
很	hmaeoo
教	jyueoo
新	xfuuii
向	xhiaee
机	jbuaaa
她	tnaiaa
内	neoooo
此	cruaaa
老	lyuaaa
变	bfaooo
原	kpuiiu
结	jceiia
问	waiaee
手	suiiii
日	rieeee
利	lliiii
质	vmeiia
已	kbaaaa
最	zieiao
政	vyueoo
儿	rkaaaa
见	jeuaaa
并	bgeeii
平	puiiii
资	zfiauo
比	biuaaa
特	tleiei
果	geoooo
什	sheiii
建	jbaooo
反	fmaooo
常	cwiaii
知	vliaee
第	dlaeuu
电	deaaaa
思	seoaoo
立	lfeeee
提	duiaei
或	hiiaee
通	txoaoo
解	jkauue
身	shuuuu
四	seeeee
品	pjiaia
几	jkaaaa
位	whoeee
别	bjiiii
论	lduoua
公	gjaooo
给	gcuoia
少	stuuuu
条	tkeioo
观	gxiaua
回	heiaee
海	htueaa
基	jyeiee
次	cfuauo
被	bdauao
山	seiiii
才	cyuuuu
己	jbaaaa
期	jyuaee
西	xyeeee
术	sboooo
济	jtoeui
认	rduooo
先	xluaaa
命	mhiaai
走	znieoo
真	vyuooo
员	kjiauo
及	jkoooo
数	sgueoo
话	hdueia
门	maaaaa
级	jcuaoo
军	jdeaii
统	tcoeua
光	gwuaaa
声	snaiuu
题	tieuia
入	rjoooo
美	mgeuoo
口	yjeeee
感	gpoaoo
战	vreaoo
科	ylooii
程	cliaee
式	sieiee
指	vuuaia
世	syaaaa
必	bdoooo
放	ffueoo
打	dueiii
接	juoeau
总	zgoaoo
做	zheiue
东	dioooo
区	qiuooo
农	ndoooo
强	jbiaia
造	zloaoo
类	lgeuoo
受	sjaooo
场	cnauuu
五	wyeeee
直	vyiaee
月	kceeee
流	ltoeui
决	jfaeoo
干	goiiii
则	zeiiii
更	gyoooo
色	skaiaa
处	ckiooo
路	ljuaia
运	kooaoo
任	rhueee
具	jeuooo
目	meeeee
再	zyeeee
治	vtaoia
神	sdiaii
求	qyoooo
件	jhueii
管	glooia
组	zciaee
根	gbaeoo
阶	jzuoui
将	jfuaei
改	gbueoo
导	dbeioo
眼	keaeoo
规	goiaua
识	sdiauo
革	gyiaii
计	jdeiii
白	bheeee
马	mceeee
金	jreeee
界	jeuoui
取	qyaooo
市	sfiaii
设	sduaao
语	kdeiia
完	wseeua
究	jsuaaa
党	dwuaaa
女	nneeee
传	cheeoo
风	fkuooo
信	xhoeee
名	mkiaee
便	bheioo
保	bhiaei
育	kfiaee
队	dzuooo
带	dyiaii
叫	jjaiii
研	kpeeii
领	lheuia
北	bruaaa
较	jioeuo
张	vbueoo
即	jbaiii
至	vieiee
许	hdueii
步	briuuu
往	wmoeee
听	tjuuii
调	dduaei
务	wkauuu
花	hwuiua
争	vkaeii
线	xceeoo
呢	njaeua
每	mlaaoo
边	bnoaoo
难	nxuioe
太	tpoooo
共	gyuooo
交	jfuouo
确	qpuaua
劳	lwauuu
据	juaeei
达	dpoaoo
住	vhoeee
收	szueoo
候	hhaeue
需	xueuii
转	vieeoo
百	bpiaee
南	nyiaou
清	qteeia
格	gbuaia
影	kiuuuu
书	scoooo
切	qiauuu
且	jeeeee
却	qnaiii
志	vnoaoo
热	ruoooo
联	lyouee
安	rsauee
极	jbuaoo
今	jhoaaa
单	cgiaii
商	sfiauo
料	lgooii
技	jueiao
深	stoaei
验	kcuooo
增	znouia
记	jdaeaa
近	jmoaoo
言	kfeeia
整	vyeiee
精	jgeeia
集	jheioo
空	yseiee
连	lioaoo
报	buaiao
觉	jsiaua
车	ciiiii
价	jhuoui
音	kfiaee
响	xjuiia
办	bnoooo
存	cpaiee
怎	zloaoo
病	bfeioo
快	ysaeoo
图	teuaoo
况	yfiaua
例	lheuii
消	xtioia
容	rsuoia
史	seoooo
非	frieee
离	lfiaoo
节	jwaiii
亲	qfeioo
万	miuuuu
八	bjoooo
构	gbuaao
族	zfueue
石	dpiaee
满	mteiei
何	hheiia
广	gfuuuu
律	lmaeii
青	qoiaee
林	lbeioo
克	yyiaua
王	woeeee
历	lpauuu
权	qbaooo
素	soaaiu
始	snaoia
断	dguuii
九	jkaaaa
际	jzeeiu
积	jliauo
吃	cjueaa
态	tpoaoo
艺	kwaaaa
证	vdeiee
众	vhuouo
创	chiiii
红	hceiee
望	wfeeee
须	xmeuia
群	qbouee
师	steiii
该	gdoeoo
复	fliaua
细	xciaee
包	bkaeaa
土	tneeee
持	cueiei
服	fcaiao
笑	xlueoo
德	dmeioa
般	bmuaao
远	kooaoo
爱	rjeuao
准	vfuioe
写	xdeaee
算	sliaeu
火	hguooo
死	spuaaa
半	bgiiii
布	bpiaii
随	szeuoa
六	lfuooo
元	kouaaa
低	dhuaoo
称	cluaiu
引	kbiiii
照	vioooo
失	sloooo
养	kguiii
视	sdiaua
习	xxeeee
段	dhuaao
字	zsaiee
织	vciauo
斗	dseiii
团	teeiuu
器	qjeuia
兴	xsuooo
乐	lkoooo
效	xfueoo
显	xiiiee
斯	syuuii
千	qliiii
落	lwooua
示	soiuoo
仅	jhaooo
企	qhieee
似	shaouo
备	bkiaee
除	czuoee
支	vyaooo
标	bbeeiu
早	zieiii
吧	bjaiaa
周	vkeiia
速	syoaoo
跟	gjaeoo
七	qiaaaa
采	cjeioo
状	vfeuoo
吗	mjaaee
约	kcuaoo
城	cneuoo
层	cbeeao
专	vooooo
划	hiiiii
轻	qiaoei
拉	luoeee
值	vheiia
适	sloaoo
英	kwiaoo
告	gliaee
讲	jdeeii
维	wcuioe
营	kwiaia
士	sneeee
环	hoeuoo
古	gyiaee
让	rdieee
院	kzooee
按	ruooau
型	xoeiee
势	suauuu
足	zjieoo
毛	mlaaaa
台	txiaee
紧	jqaaiu
片	phaaaa
属	sbuioo
严	kyuuuu
树	sbaoei
画	heiaai
厂	cpuuuu
功	gyauuu
注	vtoeee
演	ktooei
源	kteuui
温	wtiaei
某	myeioo
找	vueaoo
参	cxuuuu
易	kiuauu
飞	fnoooo
推	tuuioe
围	weeeii
列	lpiiii
客	ysuaia
河	hteiia
虽	sjiaoo
境	jnoeua
食	shoaoo
李	lbaiee
尔	rkiuoo
黄	hyiauo
黑	heoooo
念	nhoaoo
越	kneaoo
选	xloaoo
华	hheiii
角	jkuaii
考	yyeaaa
致	viueoo
夫	fooooo
初	cdauuu
装	vfoeoo
议	kdouoo
首	sguiee
委	wlauee
底	dfuaoo
另	ljauuu
江	jteiee
息	xhoaoo
密	msiaii
压	kpeioo
孩	hzoeoo
村	cbeioo
费	fbiauo
局	jbaiae
派	ptuuua
房	fdoeuu
星	xiueee
突	tseuoo
供	gheiuo
曾	cgiaee
排	puieie
苦	yweiia
够	gkuaua
像	xhuaia
站	vfieia
校	jboeuo
富	fseiae
谈	tdouou
米	mgoooo
充	cfuaaa
阳	kziaee
破	ppauao
母	mcoooo
球	qoeioo
射	sheioo
批	pueaua
配	pyaeaa
纪	jcaeaa
未	wooooo
哪	njaeai
妈	mnaaee
差	cgeiee
刚	geiiii
率	lfaaei
察	csuaee
舞	wluaea
依	khoeoo
占	vriaee
呀	kjeauu
微	wmiaue
础	cpaiii
益	kgiaee
倒	dheaii
刻	yfiiii
举	jseeii
血	xheeee
故	gyueoo
互	hieeee
范	fwooaa
木	mboooo
号	hjeaaa
尽	jboooo
请	qdeeia
脸	lcuooo
兵	bhuooo
职	vyiauo
留	lkiaee
铁	trueoo
吸	xjuaoo
钱	qreeoo
急	jkoaoo
独	dkiaoo
剧	jbiiii
查	cbiaee
皮	pnaooo
激	jtuiue
坐	zheiee
乎	hjiiii
固	geeiia
害	hseeia
夜	kfuiua
续	xceiao
京	jfiuoo
双	sxaooo
拿	nhueii
府	ffuiei
限	xzaeoo
草	cwiaei
项	xyeuia
述	sboaoo
曲	qeeeee
既	jbeaaa
春	coiaee
官	gsiaee
坚	jqeiee
令	lhoaoo
句	gkiaee
助	veauuu
简	jloiia
杂	zkeioo
材	cbeiuu
封	fneioo
护	huoauu
司	sbiaee
省	stiaee
县	xeaooo
模	mbeiia
试	sdeaei
绝	jcuaai
洋	ktouee
谁	sduioe
继	jcouaa
止	vreeee
喜	xniaee
优	kheuoo
词	cdaeia
陈	czeaoo
鱼	kkeeee
终	vcuaoo
施	sfueai
晚	wiuaia
朝	cyuaee
含	hhiaee
仍	rhauuu
脑	ncoeuo
甚	syuoaa
汉	htaooo
修	xhuauu
油	ktiaee
衣	kfoooo
击	joiiii
云	koaooo
送	sgoaoo
巴	bzaaaa
普	pgiaee
征	vmeiee
错	creiia
均	jnuaoe
投	tuuaao
波	btauao
余	kheeoo
友	kpaooo
武	woieee
责	zoiauo
游	ktoeue
敌	dlueoo
叶	xjeiii
船	cmuaia
久	jkoooo
否	fpiaee
异	kbeuii
块	ynaeoo
脚	jceiai
怕	psuiee
田	teeeee
策	cleioo
苏	swauoo
乡	xcuuuu
帝	dfiaii
靠	ylieie
医	kiueoo
测	ctiaii
植	vbeiia
啊	rjaiei
括	guueia
换	huuaia
逐	vpoaoo
娘	nnoaoo
罗	leuaoo
戏	xxeaoo
善	sgiaee
获	hwuaeu
待	dmeiei
降	jzuaea
冲	cfiaii
父	fjuooo
置	veeiia
左	zpeiee
右	kpiaee
沉	ctoaua
酸	syaouo
亮	lfuaaa
良	ldoooo
班	boouee
著	vweiia
亚	kyeeee
抗	yuoeua
啦	ljeioe
静	jouaae
渐	jteauu
概	gbaeea
居	jbeiia
跑	pjuaae
旧	jiiaee
防	fzoeuu
买	maoooo
挥	huoaea
负	fkiauo
帮	boiaii
欢	hxuauo
冷	lfuooa
液	ktoeui
停	thoeei
减	jfeuia
男	neauuu
胜	scueee
答	dluoia
析	xbuuii
忙	msoeaa
短	dleiae
烈	lpoooo
映	kiiaoo
财	ceeiuu
背	briaee
奇	jpeiia
药	kwaaua
承	czoooo
岁	seuaoo
略	leuaia
穿	cseauu
牛	nliiii
室	sseaei
移	kluaua
饭	fkuuao
坏	hneuoo
假	jhaeae
州	vgiiii
缺	qlaeoo
愿	kpoaoo
练	lceaoo
超	cnauia
雨	kyoooo
慢	msiaia
竟	jfuaaa
呼	hjuoii
散	syueoo
灵	lbouuo
副	feiiii
歌	gyuauo
谓	wdiaia
虫	ceoooo
读	ddeiao
介	jhuiii
培	pnoeia
卫	wzeeee
宗	zseeiu
章	vfeiii
评	pdeoii
伤	shueau
丰	foiiii
核	hboeoo
预	kxeuia
担	duiaee
诉	sduuoo
惊	jsoeiu
刘	lfiiii
景	jioeiu
乱	llaaaa
氧	klouee
阿	rzeiia
龙	lpoooo
宣	xseiae
升	sliiii
爷	kjaiii
洲	vtouii
判	pgiiii
案	rseioo
协	xyauoo
福	fdeiae
货	hhiauo
味	wjeeoo
若	rweuia
促	chiaie
希	xjeuia
握	wuaeea
端	dfiaeu
针	vreiii
屋	wbeaei
掌	vwueii
检	jbuooo
痛	tfaoia
闻	waeiee
妇	fnaeee
贵	geiauo
顾	gpeuia
沙	stiuuu
扩	yuoeuu
困	yeeioo
哥	gyeiia
嘴	zjieua
销	xrioia
印	kkaiii
免	mkiaaa
烟	kgiaeu
跳	tjuoau
香	xliaee
纸	vcuaaa
户	hduuuu
板	bbuuao
睛	jeeeia
误	wdiaee
探	tuoaei
座	zfuoei
盾	dmeiia
灯	dgeiii
搞	guoeia
祖	zdiaee
顺	sheuia
婚	hnuaia
赶	gneeii
季	jlaiee
兰	lgeeee
忽	hkoaoo
践	jjeeoo
熟	sfoooo
矛	mxuuuu
银	kraeoo
爸	bjaiaa
临	lqueia
佛	fhaeii
犯	fkaaaa
胞	bcuaae
讨	tdeioo
陆	lzeeii
补	bdiooo
童	tfiaee
圆	keiaia
归	gtaeee
弟	dgaeuu
域	kneaia
索	syaaiu
罪	zeieie
脱	tcouia
追	dhoaoo
守	sseioo
课	ydiaoo
顶	dyeuia
松	sbuoao
杀	sjeioo
掉	duieia
野	keaoii
训	xduiii
遍	bdoaoo
庭	tfueao
弱	rbaeoe
赛	ssiauo
额	rseuia
酒	jteiee
绿	lcaeio
席	xfiaii
露	luiaua
卖	myaooo
钟	vriaii
旁	pfoeuu
肉	reuooo
央	keoooo
染	rteioo
欧	riuauo
怀	hseuoo
稳	wluaoa
伯	bhuiee
编	bcoaia
抓	vuuuoo
玉	kooooo
咱	zjuiee
唯	wjuioe
唱	cjiaia
翻	fjaoao
释	sjaoee
控	yuooei
怪	gsaoei
阵	vzeaii
烧	sgeaeu
堂	tweiee
杨	kbauuu
您	nhoaoo
诗	sdeiei
灭	meouuo
夏	xpuaoo
敢	gbueoo
退	tboaoo
姑	gneiia
恶	ryoaoo
透	tloaoo
鲜	xkouee
附	fzuiei
骨	geiaee
审	ssiaii
胡	hyuaee
输	siuoia
宁	nseiii
丝	sceeee
姐	jniaee
彩	cjuuuu
睡	seueee
巨	jiaeee
迫	phoaoo
鼓	gneiao
伙	hhouuo
借	jheiia
耳	ryeeee
典	deuooo
刺	cyiiii
暗	rioeia
镜	jroeua
序	xfaoii
哈	hjuoia
菜	cwuoei
溶	rtoouo
笔	blueaa
汽	qtueaa
礼	ldaaaa
摇	kuuoue
迅	xboaoo
险	xzuooo
遗	weoaoo
威	wpauee
沿	ktuaia
弹	dbouia
私	slaooo
攻	gyueoo
宝	bseeoo
抽	cuiaee
雪	xuaeee
孙	sziuoo
藏	cweuei
毒	doaaoo
顿	dieuia
末	mooooo
摆	buiaei
趣	qneiao
救	jyueoo
镇	vreiuo
楼	lbouau
智	vliaee
园	keeeua
康	yfaeoo
永	kdoooo
遇	keoaoo
雄	xpuioe
替	toiaee
危	wkaaaa
楚	cbaioo
侵	qhaeao
枪	qbuoaa
冰	bfiaoo
健	jhaeao
播	buuoia
途	thoaoo
损	suiaia
秀	xlauuu
丽	leiaia
秋	qlouuo
执	vuuaoo
束	syoooo
纳	nciaoo
虑	lroaoo
疑	nkaoai
午	wliiii
粮	lgoaoo
架	jneioo
盛	cpiaee
湖	hteiua
尚	swiaia
床	cfeioo
份	fhuoau
套	tpeiao
毫	hfueaa
奋	fpiaee
扬	kuauuu
赵	vnuooo
混	htiaea
献	xyeuoo
择	zuaoee
庄	vfeiee
殖	speiia
店	dfieia
皇	hheeee
购	geuaao
缩	scooui
盐	kniaee
冬	dkoooo
齐	qfuiii
径	jmaoei
偏	phoaia
盖	ggiaee
款	ynuauo
衡	hmuaee
阻	zziaee
托	tuueaa
喊	hjeuia
繁	flaaiu
纯	cceaaa
牙	kiuuuu
殊	spueoo
浪	ltoaoo
招	vuauia
符	fluiei
折	suuuii
泽	ztaoee
弄	loeuii
奶	nnauuu
谢	xduiei
累	leaaiu
亦	kfoooo
厚	hpiaai
朋	pcuaee
伸	shiaii
筑	vleiua
闪	sauooo
枝	vbeiao
授	suuoao
蛋	dziaoo
潮	cteiua
登	dxeiae
售	shiaee
孔	yzaaaa
街	jmeiee
败	beueoo
迎	kkoaoo
肥	fcaiaa
恩	reoaoo
尼	nbuaaa
幼	kcauuu
惯	gsaaia
钢	griauo
肯	yriaee
矿	ypoeuu
岛	dkiaii
伟	wheeii
粉	fguoau
振	vueuee
吴	wjeeoo
夺	dpeioo
尤	kpoooo
忘	wfoaoo
荣	rweioo
亡	wfaaaa
阴	kzuaee
凡	fkoooo
毕	bieiii
暴	bieiio
唐	tfaeia
勇	kxauuu
避	bboaoo
麻	mfeiei
股	gcuaao
硬	kpeioo
洞	dtiaei
盘	pmiaee
轮	liuoua
警	jwoeee
闹	naoeia
录	lbiooo
绍	scauia
描	mueiia
寻	xbeioo
妹	mneeoo
幸	xnouee
壁	bbeiee
距	jjeaae
玩	woeeua
休	xheioo
延	khaooo
综	zcooee
甲	jeiiii
泛	ftuooo
哲	vuiaee
载	zyeaee
雷	luiaee
窗	csuiua
虚	xriiee
秘	bloaoo
俗	shuoia
倾	qheaeu
哭	yjeuoo
禁	jbeeiu
零	luuooa
触	ckiaoo
巧	qyeaaa
圈	jeouaa
努	nnauuu
喝	hjiaua
彻	cmeaau
晶	jiiaia
丁	dyiiii
操	cuiaei
奴	nnaooo
宜	ksiaee
菌	jwiaue
叔	sraooo
桥	qbueui
仿	fhoeuu
默	meeuoo
航	hmoeua
谷	gjiaee
泪	ltiaee
予	kxiiii
挂	gueiei
壮	vfeiee
纷	fcuoau
粒	lgoeee
燃	rguaoo
诸	vdeiia
削	xwiiii
苗	mwiaee
婆	ptauee
付	fheioo
迷	mgoaoo
馆	gkooia
灰	hpouuo
鸡	jxuaee
岸	reeuee
寒	hsoooo
泥	ntaeua
梅	mbueaa
残	cpeeoo
税	slouia
虎	hruaaa
庆	qfeuoo
抱	buuaae
鸟	dkeeee
拍	puuiee
墙	qneiia
缓	hcuoee
横	hbeiia
尾	wbueaa
督	driaee
莫	mwiaeu
械	xbeaeu
尖	jteuoo
旅	lfueua
倍	bhoeia
措	cueiia
剥	bbiiii
遭	zyoaoo
懂	dseiue
粗	cgiaee
奏	zoeeoo
润	rtoiee
侧	chiaii
辩	bfoaoe
茶	cwuoei
鬼	ghaooo
梦	mbuaoo
贯	gciauo
篇	ploaia
妻	qiauee
宽	yseiia
腿	tcaeoa
刀	dnuuuu
桌	vreioo
浓	ntoaoo
跃	kjueoo
蹈	djuoui
洗	xtueua
卷	jgaaaa
欲	kjuauo
袋	dhoeoo
赏	swiauo
悲	broaoo
劲	jxauuu
鲁	lkiaee
赞	zliauo
氏	skaaaa
汇	hteaaa
迹	jfoaoo
竞	jfiaua
醒	xyiaue
裂	lpoeoo
闭	baeiuu
森	sbeiei
腰	kceiau
磁	cpouaa
湿	stiaii
聚	jyuioo
兄	xjuaaa
徐	xmuoee
炼	lgeaoo
订	ddeiii
川	chiiii
吹	cjuauo
蒙	mweeoo
胸	xcuauo
召	sniaee
伴	bhouii
徒	tmeiie
幅	feeiae
疗	lfaiii
淡	dtouou
奖	jfeuoo
仪	khouoo
珠	voueoo
绪	xceiia
蒋	jwoeua
猪	vkeiia
剂	jfiiii
访	fdoeuu
狗	gkuaia
摸	mueiia
趋	qnuaae
宋	sseioo
伏	fheuoo
棉	mbuiia
恐	yyoaoo
羊	kgeeii
碳	tpiaeu
隔	gzeiae
网	weuouo
猛	mkaiia
爬	pmaiaa
缘	kcaaeu
麦	mouaoo
库	yfeaii
津	jtaeii
监	jqiaee
薄	bwooei
净	jfuaae
旋	xfueai
贫	pjiauo
罢	beeiao
穷	qsauuu
乏	fjoooo
挑	tuuoau
废	ffauao
汗	hteeii
耗	houeaa
尊	zgeioo
牌	phuiei
抢	cuuoaa
软	riuauo
隶	lboooo
宇	kseeii
圣	sxeiee
港	gteiae
欣	xmuauo
塞	sseiee
刑	xoiiii
博	byeiei
揭	juiaua
垂	cleeee
姓	xnueee
捕	bueioo
荒	hwoeui
诚	cdeuoo
炮	bguaae
呈	cjeeee
辑	jiiaei
卡	yroooo
伦	lhuoua
蓝	lwiiia
抬	tuaoee
宫	gsiaia
敬	jwueoo
版	bhuuao
忍	rnoaoo
颜	kfeuia
竹	vlueii
碰	ppouei
启	qdiaee
票	pyeeiu
隐	kzuaoa
抵	duuaoo
脉	mcoaoo
浮	ftuoai
煤	mgeiei
剩	sliiii
珍	vououu
奔	bpeieu
堆	dnuioe
扎	zuaaaa
谋	mdeiei
貌	mjuiua
脏	zcoeei
逃	tjoaoo
洪	hteiuo
旗	qfueei
潜	qteeia
鼻	bhiaeu
忆	ksaaaa
湾	wtoeae
绩	jceeia
恰	qsuoia
坦	tniaee
怒	nnoaoo
震	vueuee
豆	deiaou
插	cuueee
戴	dyiaei
涉	stieiu
绘	hcuoee
瓦	wioooo
龄	lruooa
池	ctaiaa
沟	gtuaao
呵	hjeiia
伍	wheiee
氢	qlaoei
拥	kuuaii
乘	clieua
吉	jniaee
尺	cboooo
朱	vloooo
蒸	vwaioo
舍	sheeia
贡	gyiauo
糊	hgeiua
梁	lteioo
漫	mtiaia
腾	tcouaa
症	vfeiee
丈	vpoooo
钻	zrieia
磨	mfeuia
井	joiiii
艰	jxaeoo
键	jraeao
绕	rceaeu
幕	mwiaii
斤	jmiiii
污	wteeaa
贝	beuooo
冒	meiaee
阔	yaooue
胆	dciaee
渡	dtoeao
碍	rpiaee
崇	ceooee
愈	khoaoo
岩	keeuia
玻	boauao
碎	spoeuo
宪	xsueua
俄	rhueoo
障	vzoeei
融	reiaoo
贸	mkiauo
耐	npeioo
届	jbiaee
寄	jseuei
荡	dwooau
币	bhiiii
俩	lheioo
卵	lkaioo
弃	qfeuii
悄	qsioia
偶	rhiaoo
纵	zcuouo
陷	xzuaui
坡	pnauao
勤	qyauuu
享	xfaiee
塑	sgeiee
膜	mceiia
铜	triaei
拖	tuueaa
暖	niuoee
稍	slioia
摩	mfueii
硫	lpoeui
哩	ljiaee
乌	wkeeee
循	xmuuei
妙	mniuuu
疾	jfueoo
肩	jdiaee
炎	kgouuo
偷	thuoia
赤	cnuioo
灾	zsouuo
恒	hseiae
孤	gzuuoo
仁	rheeee
腔	qcooei
杯	bbeuoo
乃	nnuuuu
稀	xluoeu
恢	hseuou
违	wooaoo
伊	khaeuu
挺	tuueao
乙	kaaaaa
拜	bueeii
焦	jhoooo
锋	fruaee
铺	preioo
颗	yeeuia
滑	htiaia
敏	mlueoo
洁	jteiia
嘛	mjoeei
凝	nfuaao
凉	lfoeia
杜	dbeiee
凭	phuaaa
勒	lyauuu
爆	bgiaei
递	dgoaoo
鞋	xyeiei
迁	qloaoo
秦	qoueoo
桂	gbeiei
璃	looeia
摄	nueiao
叹	tjaooo
峰	feuaee
牧	mlueoo
恨	hsaeoo
糖	tgoeae
骂	mjaaee
贴	teieia
紫	zraaiu
壤	rnoeia
辛	xfeiii
仰	khuaai
腐	ffiauo
割	gsiiii
辈	breaii
君	jbiaee
泡	ptuaae
郭	gfaiii
呆	djeioo
番	fjiaee
励	lpauuu
乳	rjaaaa
亿	khaaaa
兼	jgoooo
昨	ziueee
刊	yoiiii
擦	cuooua
迟	cboaoo
拔	bueuao
丹	dkeeee
彼	bmauao
搬	buuuua
眉	mziaee
滴	dtoeia
朵	dkeioo
畜	cfiaee
遵	zgoaoo
逻	leoaoo
患	heoaoo
奥	rheuoo
耕	goeeii
忠	veoaoo
鉴	jquoee
挤	juoeui
滚	gtoeuo
壳	ynuaaa
厅	tpeiii
旦	dieeee
炸	vgueee
塔	tneiuo
频	preuia
弯	wfaeaa
狂	ykeeee
陶	tzuaue
晓	xieaeu
柳	lbuaai
炉	lgoauu
宏	hseuao
愤	fseiia
瞧	qeuioo
箱	xleiia
扑	puiooo
暂	ziiaee
盆	pjiaee
瓶	pgeaoo
柱	vboeee
辉	hwoaea
雅	kiuioe
衰	cfiaua
洛	ltuaia
朗	lduaee
琴	qouooa
腹	fcueia
牲	slueee
黎	lluoio
肃	sboooo
雾	wuuaau
冠	gdeeei
伪	whouoo
幻	hcaaaa
仔	zhaiee
杰	jboooo
烦	fgeuia
悟	wseiia
荷	hwuiei
晨	cieuee
甘	gyeeee
饱	bkuaae
飘	pyuauo
芳	fwoeuu
肌	jcuaaa
舒	shaoii
惜	xseiia
丧	syauoo
肚	dceiee
灌	gteiia
抑	kuuaai
鸣	mjuaee
辞	cloeei
宙	vsiaee
邻	lhaiii
昌	ciiaee
扫	suaeee
赖	lyuaia
泉	qhiaoo
肠	ccauuu
鼠	shaoao
援	kuuoee
墨	meeiee
啥	sjuoee
祥	xdouee
储	choaei
萨	swaioe
裁	cyoeoo
奉	foeeii
傅	fheiei
姿	zfauee
埋	mniaee
亩	mfiaee
犹	kkeuoo
瓜	gmoooo
咬	kjoeuo
粘	ngieia
芽	kweauu
吐	tjeiee
昆	yieaua
估	gheiia
租	zliaee
碗	wpooua
轨	giuaaa
稻	dluoui
纲	gciauo
役	kmuaao
勃	byauuu
毁	hhuaao
烂	lgouee
昏	hkiaee
隆	lzuaue
饰	skueia
曹	cyiaee
仙	xhiaii
夹	guoooo
爹	djuaua
郑	vgaiii
闲	xaeioo
柔	rxeioo
吓	hjeioo
嫂	snuiao
巩	gyuaoo
亏	yoaaaa
帽	meiaia
浅	qteeoo
详	xdouee
斜	xhooei
佳	jheiei
饮	kkuauo
猫	mkeiia
杆	gbeeii
恋	lfoaoo
凤	fkaooo
缝	fcuaoa
疏	szoeui
扶	fueeoo
厉	lpeauu
喷	pjeiia
截	jyuioe
扰	rueuoo
拨	buauao
雕	dkuioe
码	mpaaee
瑞	roiaeu
讯	xdaeii
莲	lweaoa
邦	boaiii
贷	dhiauo
丢	dlaooo
慌	hseioe
寿	soeioo
毅	kfuaao
漂	pteiee
屈	qbaiii
涂	ttuoee
蜂	feuaee
猎	lkeiia
氯	llaeio
劝	qxauuu
柴	creioo
悉	xjoaoo
狠	hkaeoo
岗	geiauo
饲	skaeia
祝	vdiaua
皆	jiuiee
罚	feoaii
躺	thioia
桃	tbuoau
猴	hkuiae
宿	ssuieu
锅	griaia
胶	jcoeuo
偿	chioee
宾	bsuiuo
译	kdaoee
袭	xpoeoo
串	ceiiii
申	seiiii
捉	vuiaie
挖	wuooaa
窝	wsiaia
踏	tjiaia
邓	dxaiii
允	kxuaaa
舌	sliaee
溜	ltuaia
驻	vcoeee
膀	bcoeoe
渔	ktuaee
纠	jcaiii
冻	dfeaoo
扭	nuaiee
臣	ciiaii
埃	rnaoue
辐	fieiae
闷	maoaoo
涨	vtaeue
签	qluooo
秒	mliuuu
贺	hniauo
耀	kwaoui
辨	bfouoe
燕	kyiaoo
慰	wboaoo
颇	pneuia
债	vheeia
肺	fceiii
逼	beoaoo
魂	houiao
匆	ckoooo
旺	wieeee
姻	kniaeu
吞	toiaee
甜	tleiee
吨	djeaaa
搭	dueiuo
屏	bbouee
掩	kueuia
涌	ktaoia
袁	kniaua
汤	stauuu
岭	leuooa
拟	nuaouo
慧	hooaoo
郎	ldaiii
瘦	sfuiao
阅	kaouia
辆	lieioo
填	tneiuo
袖	xdiaee
匀	kkoeee
娃	wneiei
筒	tliaei
豪	hfeuoo
籍	jleeei
餐	cruooa
轰	hiaoao
尘	cteiee
敲	qfieao
帐	veueoo
撞	vuoeia
钠	nriaoo
牢	lsueii
肿	vciaii
盲	mfiaee
腊	lceiia
锐	rrouia
返	fmoaoo
骗	pcoaia
骑	qceuei
扣	yuiaee
寺	sneioo
沈	stoaaa
醉	zyoeuo
纹	wcoeoo
纺	fcoeuu
泰	toiooo
盟	miiaee
辟	bboeei
丛	cheeee
拒	jueaae
忧	kseuoo
魏	wluiao
躲	dhuaei
纤	qcueii
肖	xwiaee
悬	xeoaoo
旱	hieeii
晋	jyiaee
祭	jkeeiu
誉	ksoeee
谱	pdouia
箭	jlouia
狭	xkeooo
饿	rkueoo
驱	qceauo
冯	ffaaee
脂	vcuaia
斥	cmoooo
肤	fceeoo
椅	kbeuei
栽	zyeioo
仗	vheuoo
墓	mweiee
舅	jhiaau
碱	jpeuia
兽	sgeiae
锁	srioia
喂	wjiaea
抛	puuaau
苍	cwuoaa
臂	bbiaee
溪	xtuoaa
胖	pcouii
伐	fheaoo
汪	wteeee
刷	sbiiii
稿	gloeia
绳	sciaia
剪	jgauuu
唤	hjuaia
凶	xjaiii
邮	keaiii
齿	cruoai
尝	cweeao
漠	mteiia
怨	kkoaoo
络	lcuaia
撤	cuoeue
撒	sueiue
筹	cleeei
幽	keaaaa
渗	staoeu
蛇	seooua
诱	kdueau
抚	fueeaa
磷	lpouua
逆	ngoaoo
牵	qpueii
诊	vduouu
惨	csaoeu
抖	duooei
庙	mfiaee
株	vbueoo
浑	htoaea
驶	sciaoo
泼	ptauao
厌	kpeuoo
怜	lsuooa
疲	pfauao
厘	lpiaee
叙	xhaooo
嫁	jnooeu
跨	yjeuee
惠	hyoaoo
哀	rfiaua
胃	weiaee
蜜	msiaoo
梯	tbouae
诺	ndeieu
悠	khoaoo
滩	ttaoui
笼	lleuoo
添	tteeio
陪	pzoeia
挨	ruaoue
拳	qgueii
晃	hiioua
寂	jsieao
倡	chiaia
催	chiaui
朴	pbiooo
郁	kpaiii
脊	jfiaee
扇	sdaoao
仓	chaaaa
魔	mfuiao
哎	rjeiuo
蓄	xwoeia
棵	ybiaoo
胀	vcueoo
眠	meaeaa
劣	ltauuu
秩	vlueoo
塘	tnoeae
孟	mziaee
媳	xnuioa
廷	tlaooo
铃	lruooa
胎	tcaoia
抹	mueeoo
吵	cjiuuu
肢	vceiao
拾	suuoia
聪	cyouoa
寨	vseioo
翠	cxoeuo
赫	hneiui
尿	nbiaoo
疼	tfuaoo
览	lqiaua
狼	lkoaoo
轴	viiaee
锦	jruiia
夸	ypeeaa
剑	jhiiii
牺	xleiee
翼	kxiaei
卧	wiiooo
曼	miiaao
姆	mnaaoo
匠	jiuuii
熊	xxoooo
搜	suuiao
盈	kniaee
覆	fyuuue
唇	cpiaee
驾	jnaaee
腺	xcuiia
辅	fieioo
枯	ybeiia
鞭	byuiei
翅	cyaoao
喘	cjiaeu
肝	gceeii
掘	juaeai
歪	wpeiee
欺	qyuauo
疆	jbeiae
赋	feeeie
婶	snooia
畅	ceauuu
葡	pwuaei
脾	pcuiei
哼	hjoeai
柜	gbeaae
兔	tkoooo
顽	woeuia
藻	zwooia
鸭	keuaee
页	kpiauo
谐	xdeaui
侦	vhieia
仇	chuaaa
睁	veuaae
茫	mwoooe
拼	puouee
炭	teeuou
锡	xriaua
弦	xboeaa
滋	ztouaa
锻	druiua
脆	ccuaaa
裤	ydoeea
卢	lraeuu
萌	mwiaua
骤	vceiui
悦	ksouia
氮	dlouou
葬	zweueu
棒	bbeeee
渠	qteioo
诞	dduiao
斑	booeee
浩	htueia
盒	hhiaee
遥	kjoaoo
颤	cfeuia
扮	buuoau
扯	cuieee
颈	gxeuia
玲	louooa
丑	czeeee
摊	tuaoui
桑	sxeioo
盗	dfiaee
柏	bbuiee
唉	rjaoue
戒	jieuii
凌	lfeiuo
羽	kxaoee
胁	xcauoo
捷	jueaoo
皱	vkauao
堡	bheiee
嚷	rjoeia
挣	vuuaae
淋	lteiei
陵	lzeiuo
彭	bnuuuu
茂	mweuoo
吊	djiaii
愁	cloaoo
巡	xcoaoo
寸	cyoooo
纱	sciuuu
惑	hioaoo
董	dwueee
勾	gkaooo
昂	riuaai
阐	caouia
纬	wceeii
逢	fkoaoo
披	puauao
恼	nsoeuo
佩	phuaei
妥	tjauee
萄	twuaue
迈	mioaoo
坛	tneeao
署	seeiia
姨	kneaoo
肾	sqiaee
仲	vhiaii
邀	khoaoo
莱	lweooo
辽	lzoaoo
阀	fauiea
猜	ckeeia
弥	mbuaiu
瞪	deaoei
韩	hyeeii
臭	cheuoo
脖	bceiai
掏	tuuaue
妨	fnoeuu
燥	sgiaei
酷	yyueia
蚁	keouoo
鸿	htuaee
棚	pbuaua
芦	lwoauu
漏	ltaeei
凯	yeuaaa
浸	jtaeao
舰	jmiaua
狱	kkoaeu
踪	zjooee
氛	fluoau
摘	vuoeia
御	kmueai
蔡	cwuaee
扔	ruauuu
硝	xpioia
裕	kduoia
氨	rlooau
竭	jfiaua
蚕	coiaoo
疯	ffuauo
坑	ynoeua
愉	ksuoia
矮	rlueau
嘉	jnauia
掠	luoeia
泄	xteiaa
叉	cxoooo
渴	ytiaua
冶	kfaoia
囊	nyiaee
辣	lfeioo
菊	jwuaou
凑	cfeeee
歇	xiuauo
嘻	xjeiia
雇	gduioe
婴	keauee
泌	btoaoo
痕	hfaeoo
亭	tfeiii
跌	djueoo
夕	xkoooo
册	ckeeee
螺	leiaaa
贮	veooee
淀	dtooei
贪	thiauo
庞	pfeuoo
铝	lriaia
砖	vpeeoo
僚	lheuia
涛	tteeei
耶	kyaiii
艳	kouaai
玛	moaaee
拆	cuuuoo
绵	mcuiia
遮	vfoaoo
慎	sseiuo
贾	gyiauo
贤	xqiauo
糟	zgeiia
鹿	lfeaua
霸	bueiua
匹	piuaaa
挡	duioae
舱	cmuoaa
咳	hjoeoo
雀	qtuioe
赴	fniooo
蚀	skiaoo
咽	kjiaeu
饥	jkuaaa
鹰	kfuaee
询	xduaia
嘿	hjiaoo
函	hzaiii
堪	yneiuo
嗓	sjaoei
嫩	nneiue
晴	qieeia
蹲	cjouei
辖	xiooee
豫	kxuaia
酬	cyouii
剖	pfiiii
钾	jriaii
尸	sbuuuu
胚	pceuee
悔	hsueaa
雌	cruioe
哦	rjueoo
惩	cmoaoo
漆	qteiuo
篮	lliiia
链	lreaoa
筋	jluaau
摔	suoeaa
遂	sgoaoo
叠	dxiaee
霍	huuioe
垄	lpeiee
匪	fiieie
侯	hhaeue
巾	jeiiii
贞	vriauo
丘	qheeee
滞	vteiia
洒	steiee
纽	ncaiee
蓬	pwuaoa
浙	vteiuu
潘	ptuoia
娜	nnaeai
矩	jleaae
闯	caaaee
盼	peuoau
叛	pguuao
履	lbuuue
霞	xuaeae
菲	fwieie
瞬	seuoua
奸	jneeii
砍	ypuauo
敦	dfueoo
浆	jfiaoo
儒	rheoeu
拓	tueuia
僧	shouia
棋	qbeiuo
芬	fwuoau
俺	rheuia
慈	cgoaoo
萧	xwaeoo
蛮	mfiaoo
郊	jfaiii
勉	mkauuu
钉	dreiii
缠	ccoeia
盯	deeiii
吾	wyiaee
咕	gjeiia
膨	pceiuu
堵	dneiia
卜	bwoooo
扁	bdiaii
葛	gwiaua
哟	kjaaua
寡	gseuau
鄂	rjaiii
驰	ccaiaa
桶	tbaoia
晒	sieiee
慕	mwiooo
栏	lbouee
霜	sueiia
谊	kdooia
哇	wjeiei
畴	ceeeei
隙	xziuia
孝	xyaiee
押	kuiaii
竖	sqoeee
喉	hjuiae
欠	qkuooo
衫	sduuuu
吕	ljiaee
旬	xkiaee
韵	kfuaoe
霉	muueaa
邪	xiaiii
孕	knaiee
穆	mluiiu
硅	gpeiei
峡	xeeooo
湘	xteiia
澳	rtuieu
羞	xgaiee
惧	jsiauo
慨	ysaeea
穴	xsuooo
捞	lueiau
辱	rpeioo
棍	gbiaea
撑	cuioue
炕	ygoeua
窄	vsueee
崖	keeuei
俱	jhiauo
宅	vsueaa
陕	szeooo
爽	spuouo
鹅	rluaee
晰	xieiuu
巢	cciaoo
绒	rceaeu
疫	kfuaao
茎	jwaoei
苹	pweoii
捧	pueeee
忌	jboaoo
搏	bueiei
奈	npeeiu
躯	qheauo
惹	rwoaoo
焰	kguaui
岂	qeaeaa
甫	fyoooo
艾	rwuooo
拦	luouee
趁	cnuouu
缚	fceiei
祸	hdiaia
橡	xbuaoo
碧	boeuia
卑	bheiii
攀	pbeuue
饼	bkouee
蔬	swaioe
譬	pboeee
灶	zgeiee
赔	peoeia
粪	fgeiuo
颠	dyeuia
曰	keeeee
媒	mneiei
殿	dbuaao
蛙	weeiei
衬	cdeioo
钩	gruaao
逝	suoaoo
哑	kjeiee
艇	tmueao
罩	veieia
裸	ldiaoo
岳	khiaii
庸	kfaeii
嫌	xnouoo
窃	qseaau
涵	htaiai
砂	spiuuu
梨	lleioo
泊	btuiee
遣	qeoaoo
熔	rgoouo
廉	lfouoo
傲	rheeue
傻	shuiuo
畏	weeaoo
缴	jcuiue
钙	greiaa
铅	qruaia
乔	qluiii
懒	lseiua
萍	pwooeo
莉	lwueii
挽	wuuaia
凄	qfeaau
刮	gliiii
卓	vreiii
档	dbioae
妄	wfauee
劫	jnauuu
阁	gauaia
掀	xuuuua
哗	hjuiei
藤	twuaou
吟	kjuooa
杏	xbiaee
颂	sjeuia
梢	sbioia
罕	hdeeii
沸	ftaeii
滨	btooui
翔	xgaoao
汁	vteiii
戈	gioooo
愚	keoaoo
秧	kliaoo
抒	suaoii
弊	bgeuii
姜	jgauee
拘	guuaia
贩	feuuao
框	ybeaee
屁	pbeaua
喻	kjuoia
嘱	vjaeui
垫	dueiee
迪	deoaoo
契	qoeuoo
弗	fbiiii
瑶	kououe
赌	deeiia
堤	dniaei
哄	hjeiuo
旨	vkiaee
晕	kioaea
凳	dxuaaa
址	vnieee
彪	bruuuu
踢	tjiaua
俊	jhaouo
韦	woiiii
贼	zeeaeu
稚	vluioe
蝶	deeiei
账	veueoo
凹	reeeee
帕	peuiee
携	xuuiau
茅	mwaouu
枢	sbeauo
溃	ytiaia
哨	sjioia
枚	mbueoo
驳	bcuouo
歧	qreiao
抄	cuiuuu
弓	gbaaaa
稼	jlooeu
颁	bjeuia
徽	hmiaue
杠	gbeiee
泳	ktoaoo
蜡	leeiia
吻	wjuauu
沾	vtieia
绣	xcueau
叮	djeiii
谨	jdeiia
厨	cpeiei
拐	guiaau
宴	ksiaau
鸦	kiuaee
衷	vfiaua
戚	qpieiu
粹	cgoeuo
碑	bpuiei
煮	vyoooo
蕾	lweoia
淑	stieao
逸	kkoaoo
翁	wjaoao
倘	thioia
恳	yboaoo
逊	xzoaoo
趟	tnioia
讼	sduoao
衍	kmooee
蔽	bwouue
胳	gcuaia
罐	gleiia
裙	qdaeia
龟	gkiaaa
奠	dgeuoo
颌	gheuia
驴	lcoauu
撕	sueiuu
蒂	dwoeia
姚	knuoau
滥	ltiiia
恭	gyiooo
耻	cyieee
蕴	kwaaia
骄	jcueui
煌	hguiee
冤	kduaoo
瞎	xeooee
娇	jnueui
杭	hboeua
倦	jhouaa
愧	ysuiao
淮	htuioe
柯	ybeiia
聊	lyuaai
侨	qhueui
萝	lwiaua
惟	wsuioe
谅	ldoeia
瘤	lfuaia
蚂	meaaee
崔	ceuioe
廊	lfoaai
溉	gtaeea
铸	vreeei
髓	seeuoa
碌	lpaeio
拢	lueuoo
沫	mteeoo
帅	stiaii
坟	fnoeoo
娱	kniaee
吏	lyoooo
峻	jeaouo
昼	vbiaee
歉	qguauo
刹	cjiiii
坝	bniauo
栖	qbeiee
捐	juiaia
渊	ktuoue
傍	bhoeoe
叭	bjuooo
鸽	ghuaee
淘	ttuaue
轿	jiueui
呜	wjuaee
宰	zsoeei
谦	qdouoo
玄	xfaaoo
丙	byoooo
愣	lsiaoe
朽	xbeaaa
跪	gjuaaa
券	jgauuu
寓	ksiaoo
捏	nuiaei
搅	juooia
笨	bleiee
槽	cbeiia
咋	zjueee
厦	speuua
爪	vmoooo
奎	ypeiei
榜	bboeoe
屠	tbeiia
耸	sheiee
驼	tcooua
甩	skaaaa
逮	dboaoo
殷	kmuaao
赚	veouoo
歼	jpueii
孢	bzuaae
僵	jheiae
矣	kxueoo
锤	crueee
浴	ktuoia
呐	njiaoo
兹	cgaaaa
坎	ynuauo
珊	souaee
苯	bweiee
垦	ybeiee
兜	dhuaaa
禅	cdouia
芝	vwoaoo
吁	xjeeii
酶	myueaa
舆	khuooo
惶	hsuiee
咐	fjuiei
瓷	cfeaoo
陌	mzeuia
颖	kkeuia
帘	lsiaii
摧	cuiaui
赢	kfiaua
裹	gfiaua
瞅	ceueou
卸	xlaiii
兆	vjauoo
咧	ljeuii
噢	rjuieu
仆	phiooo
膊	bceiei
醇	cyoeai
饶	rkeaeu
嗯	rjiaoa
篷	pluaoa
膝	xceiuo
肪	fcoeuu
寞	mseiia
挫	cuuoei
俯	fhoeui
桔	jbeiia
蚊	weoeoo
熙	xioooo
巷	hyaeaa
眨	veuooo
烛	vgiaoo
踩	cjuoei
缸	gleiee
屯	qiaaaa
顷	qieuia
鼎	deaeie
砸	zpeaia
乾	gyueaa
咸	xpiaee
沃	wtueoo
衔	xmueee
俘	fhuoai
熬	rooooo
喇	ljeiii
芒	mwoeaa
钓	druaoo
侍	sheiei
禽	qhoeia
桩	vboeei
灿	cgiaii
吼	hjaiaa
泣	qtoeee
讽	fduauo
凸	treeee
谭	tdeiia
敞	cwueoo
聘	pyiaea
哺	bjeioo
癌	rfiaia
浦	pteioo
躁	zjiaei
卿	qkaeai
勘	yyauuu
窜	csiaii
溢	ktouia
舟	vmoooo
楞	lbiaoe
虹	heeiee
蛛	veueoo
耍	spauee
饵	rkeiee
烷	wgooee
骚	scaoia
枣	zyoooo
浇	jteaeu
崩	beuaua
蹦	bjiaua
褐	hdiaua
嘎	gjeuea
俭	jhuooo
仑	lhuaaa
窟	ysaeai
陡	dzeiie
荫	kwaiua
嚼	jjuoia
倩	qheeia
钦	qruauo
弧	hbuuoo
涡	gtiaia
潭	tteiia
坊	fnoeuu
缔	dcoeia
廓	yfoeai
佐	zheuei
夷	kioooo
眯	meouoo
枕	vboaaa
捣	duuaia
蹄	tjoeia
猩	xkiaue
狐	hkuuoo
柄	bbeioo
穗	sleioa
伞	shouii
拚	puaoeu
浊	vtiaoo
壶	hniiee
冈	geuooo
搁	guoiua
屑	xbioia
谬	mdaouo
拱	gueiuo
魁	yhooei
祀	sdaeaa
荧	kwouuo
誓	suoeee
斋	vfeuii
虾	heeioo
绸	ccuaei
魄	bhuiao
娟	jniaia
姊	znuauu
秃	tluaaa
泻	xtoaea
鹏	pcuaee
蟹	xkiaoo
斌	bfeeie
灼	vguaoo
扛	gueiee
镁	mroueu
瓣	bfuuoe
艘	smuiao
捆	yuiaei
膏	gfiaee
苇	wweeii
厢	xpeiia
妮	nnaeua
蒲	pwooei
啸	xjaeoo
劈	pbauuu
滤	ltieoa
葱	cwuaoa
栗	lyeioo
袍	pduaae
耽	dyoaaa
痴	cfueia
颊	jueuia
猿	kkeiia
沪	htoauu
怯	qseiao
垒	lxeiee
芭	bwaiaa
蔑	mwiaeu
絮	xnaaiu
咯	gjuaia
笛	dliaee
嘲	cjeiua
爵	jjaeei
瞒	meeiei
冀	jriaei
赐	ceiaua
酿	nyoaoo
烫	ttouuo
惕	tsiaua
逗	deoaoo
挪	nuaeai
吱	vjeiao
淫	ktuoue
糕	ggouoo
剿	cciiii
拣	jueaoo
琼	qooeia
塌	tniaao
渣	vteiii
澄	ctaoei
赠	zeouia
媚	mnaiia
荐	jweuai
暑	sieiia
鹤	hduaee
绅	sciaii
讶	kdeauu
凿	zqouai
烁	sguaoo
狮	skiuei
乒	phuuuu
薛	xwuioe
侮	whueaa
阎	kauaui
嗽	sjeiua
朦	mceiee
喃	njeiia
埔	bneioo
蝇	keiaia
锣	lriaua
炒	cgiuuu
娶	qyauee
棕	zbooee
韧	roauoo
礁	jpuioo
陀	tzooua
肆	syaeii
乖	glieua
禄	ldaeio
骆	lcuaia
驯	xcuiii
匙	ciuaaa
萎	wwueau
舶	bmuiee
滔	ttuoui
卤	lriauo
摹	mwueii
昔	xyiaee
陋	lzeiaa
雁	kpuiui
耿	gyouuo
裳	cwoeoo
崭	veeauu
妆	vfauee
勋	xjauuu
侣	lhiaia
闸	vaiaii
贬	beuooo
痰	tfouou
喧	xjooei
膛	tcioei
胧	lceuoo
辫	bfaaoe
烯	xguoeu
丫	kgiiii
铀	kriaee
甸	dkiaee
犁	llueii
幢	ceoeia
窑	ksueii
羡	xgoeua
坪	pneoii
缀	vcaoao
坤	yniaii
汹	xtuoai
柑	gbeiee
淹	kteuia
杉	sbuuuu
棺	gbooia
怖	bseuia
腻	nceaee
薯	swiaei
锈	xrueau
魅	mheeoo
炳	bgeioo
洽	qtuoia
诵	sdaoia
咪	mjouoo
椎	cbuioe
畔	peouii
玫	moueoo
柿	sboeia
帜	veiauo
桐	tbiaei
襟	jdeiee
筷	ylooae
帆	feuaoo
唔	rjeiia
匈	xkuoai
嵌	qeeiua
梳	sboeui
鳞	lkouua
佣	khuaii
莎	swooiu
熄	xguioa
砌	qpeaau
昧	mieeoo
噪	zjiaei
簧	hleiia
婉	wnooua
毯	tlouou
孵	fkuoai
憾	hseuoa
谎	hdeioe
坠	vzeiee
煞	skoooo
藉	jweeei
嗡	wjuoao
绑	bceeai
妖	knueoo
蝴	heeiua
瑰	gouiao
揉	ruaoei
苔	twaoia
拌	buouii
莹	kweeoo
昭	viauia
汰	tteuoo
拂	fuaeii
嗅	xjuieu
钮	nraiee
鄙	bjaiii
撰	vuaeei
盏	voiaee
烘	hgeiuo
谣	kduoue
稣	skueoo
竿	gleeii
皖	whooee
锥	vruioe
烃	tgaoei
犬	qpoooo
喀	yjooua
皂	zheaaa
蔓	mwiaia
蕊	rwoaoa
疮	cfuoaa
咒	vjuaaa
僻	phaeoe
炯	jgiaia
寇	yseeie
铭	mruaia
薪	xwoeuu
恍	hsioua
辰	cpeeoo
祈	qduuii
迭	dloaoo
豁	hsuoia
斩	viuuii
屡	lbouau
啼	tjoeia
椒	jbieao
啡	fjieie
稽	jleuua
烤	ygeiea
澡	ztiaei
籽	zgaiee
洼	wteiei
茨	cwoeua
榴	lbuaia
唾	tjueee
巫	wyuouo
乞	qlaaaa
焊	hgiaee
杖	vbeuoo
贱	jeeeoo
咚	djuaoo
蜘	veueia
扒	buuooo
隋	dzeuia
晌	siuiia
暮	mwiaee
涤	dtuaei
茧	jwiaoo
拴	suuoee
闽	maiaoo
叨	djauuu
伽	ghauia
喳	cjeiia
腕	wcooua
斧	fjuuii
怔	vseiee
咖	gjauia
啄	vjeuoo
溯	stouua
踱	djoeao
沦	ltuoua
锄	criaau
畸	jeeuei
脓	ncoaoo
疙	gfueaa
炊	cguauo
擅	suoeia
粤	kheaaa
虏	lrauuu
豹	bjuaoo
榨	vbooue
棱	lbeiuo
簇	cloeue
莺	kwuaee
撇	puouue
绎	kcaoee
尉	wbeioo
柬	jyoooo
涩	stauie
乓	phoooo
觅	mjiaua
茄	jwauia
涯	kteuei
狩	skooei
憎	zsouia
蔚	wwaeei
挚	vuueii
姥	lneiua
袄	rdueoo
捡	juuooo
旷	yioeuu
镶	xroeia
碘	dpiauo
袜	wdeeoo
丸	wkoooo
糙	cgueoa
鲸	jkoeia
铵	rrooau
倚	kheuei
矢	sloooo
锌	xroeei
褂	gdeiio
牡	mleiee
硕	speuia
憨	hboaoo
淌	ctioia
禾	hloooo
尹	kbuuuu
荆	jwiiii
苟	gwuaia
聋	lpeiee
潇	xteiae
庐	lfoauu
煎	jgoooo
勿	wkuuuu
彬	bbeiuu
醋	cyeiia
梭	sbaouo
秉	bloooo
嗦	sjeiaa
掷	vuouai
悼	dsieia
噜	ljuaia
茵	kwiaeu
蓉	rwoouo
矫	jlueui
憋	bgoaoo
翘	qiaoao
琢	voeuoo
挠	nueaeu
吭	hjoeua
兑	dgiaua
蔗	vwoeoo
瑟	sooaoo
痒	kfouee
琐	soioia
酋	qgeiee
廖	lfaouo
璋	vooeei
槐	hbuiao
闺	gaeiei
拧	nuooei
彰	vfuuuu
菱	lweiuo
呕	rjeauo
瘩	dfeiuo
筐	yleaee
搂	luouau
焚	fbouuo
迄	qloaoo
垮	yneuee
缕	lcouau
谜	mdouoa
钥	kruaee
嘟	djeiai
蠢	coiaia
蛤	geuoia
馈	ykiaia
咨	zfiaee
敷	fyueoo
缅	mceuee
聂	nyaoao
宠	cseuoo
禧	xdeiia
沼	vtauia
巍	weueui
榆	kbuoia
宛	wsuaaa
绷	bcuaua
俞	khiaii
眶	yeeaee
吩	fjuoau
筛	sliuei
菩	pwoeia
钞	criuuu
诈	vdueee
嗨	hjooue
葫	hweiua
佃	dhiaee
酱	jfeiee
颓	tleuia
渺	mtiaiu
揽	luiiia
躬	ghaeaa
歹	dpoooo
焕	hguaia
啪	pjeiui
溅	jtiaee
栋	dbeaoo
沛	pteiii
砚	kpiaua
霖	lueiei
囚	qeuooo
侄	vheaei
妃	fnaeaa
氓	mfaeaa
狡	jkoeuo
瞥	pgiaee
沁	qtoaoo
揣	cuiaeu
峭	qeioia
樱	kbiaau
禹	khoooo
岔	cjiaii
暇	xiaeae
檐	kbuaoe
澜	ltoiei
涅	ntiaei
粥	vbouae
馏	lkuaia
嗜	sjeiia
笃	dlaaee
麟	lfouua
铲	croeuu
寅	kseiuo
剔	tiiiii
尧	kieuaa
扼	rueuaa
赣	gfuaei
稠	cluaei
屿	keeaee
胺	rcooau
帖	teieia
堕	dzeiee
亥	hfoooo
揪	juueou
梧	wbeiia
麓	lboeea
瀑	btiaei
窍	qseiea
懈	xsuaau
淤	ktoeuo
腮	sciaoa
腥	xciaue
绞	jcoeuo
鹃	jjuaee
卒	cfuoei
蕉	jwuioo
枫	fbuauo
脯	fceioo
腑	fcoeui
碟	dpeiei
莽	mweueu
毙	bieuua
婷	tnoeei
磕	ypeiia
熏	xloooo
酵	jyeiai
薇	wwuuia
溴	xtuieu
弛	cbaiaa
挟	jueooo
棘	jyeioo
秤	cleoii
睹	deeiia
庚	gfaeoo
蚓	keaeii
咀	jjiaee
绰	ccieia
锰	mraiia
炽	cgiauo
枉	wbeeee
俏	qhioia
梗	gbeioo
祷	ddeeei
逛	gkoaoo
茸	rweiee
葵	ywaoee
蜀	seuaia
狄	dkouuo
拙	vuaiii
鞍	ryooau
婿	xnaiia
掺	cuaoeu
钧	jruaoe
蚯	qeuiee
圃	peeioo
蛾	reueoo
嚣	xjeuia
垃	lnoeee
紊	wfaaiu
酚	fyuoau
隘	rzouia
韬	tououi
鲫	jkaeai
笋	slaeuu
啃	yjieia
叽	jjuaaa
鲤	lkiaee
惰	dseuia
嘀	djoeia
诬	wdeiuo
哮	xjeiai
羔	ggoooo
毡	vlieia
勺	skoooo
狸	lkiaee
娥	rnueoo
郡	jbaiii
瘫	tfaoui
钝	dreaaa
湍	ttiaeu
趾	vjieee
跋	bjeuao
靖	jfeeia
妒	dnoauu
锯	jraeei
畲	shiaee
弘	hbaooo
湛	vteiuo
咦	kjeaoo
袱	fduieu
咙	ljeuoo
圾	jnuaoo
藩	fwoouo
颅	lreuia
弼	bbeuae
鲨	stuaee
嗬	hjeiui
翩	pdaoao
忿	fjoaoo
刨	bkiiii
捂	wueiia
痹	bfiaeu
灸	jkouuo
虐	nreaee
芙	fweeoo
鹊	qyuaee
簿	blooei
绢	jciaia
戳	cxeaoo
徊	hmieai
澈	ctoeue
疤	bfaiaa
棠	tweioo
扳	buuuao
诏	vdauia
沧	ctuoaa
蹬	djaoei
窥	yseeia
窖	jsueia
疟	nfeaee
呱	gjuuoo
湃	ptueee
淳	ctoeai
眷	jgiaee
匣	xiiaii
烙	lguaia
佑	kheuia
慷	ysoeae
轩	xieeii
焉	kyeaoo
芸	kweeao
琳	loeiei
恺	ysiaae
嘶	sjeiuu
馒	mkiaia
哆	djuaua
崎	qeeuei
嫉	jnoeue
冥	mdiaoe
徘	pmieie
辜	gyoeei
姬	jneaii
捎	suioia
绥	scuoau
窘	jsaeia
诀	jdaeoo
龚	gpeiuo
橙	cbaoei
诧	cdooue
诡	gduaaa
峨	reueoo
逾	khoaoo
裴	proeoo
椭	tbaieu
嗣	sjaeia
讳	hdeeii
粟	syouoo
轧	giaaaa
咏	kjoaoo
衙	kmeiee
虔	qroeoo
梵	fbuaoo
豚	tceuoo
邢	xoaiii
梆	bbeeai
剃	tgiiii
吆	kjaaoo
奢	speiia
叩	yjaiii
拎	luuooa
芹	qwuuii
瑛	koeiia
翰	hyuoao
邹	zkaiii
淆	xtuoeu
厥	jpouua
缭	lceuia
髦	myueaa
斡	wyuooo
羌	qgaaaa
磅	bpoeoe
郝	hnaiii
芯	xwoaoo
卉	hyeuii
诫	jdeaeu
驮	dceuoo
骼	geuaia
蜕	teouia
崽	zeiaoa
墩	dnoeue
迦	jnoaoo
屎	sbouoo
陨	kziaia
桦	hbuiei
敛	lhueoo
倪	nhuiua
讥	jduaaa
鳃	skiaoa
氟	flaeii
祠	cdaeia
晤	wieiia
趴	pjuooo
瑚	hoeiua
苛	yweiia
寥	lsaouo
惭	cseauu
宵	xsioia
靶	byaiaa
倌	ghooia
砾	lpuaoo
厕	cpiaii
钳	qreiee
肘	vceioo
眺	teuoau
甭	bpuaii
呗	bjiauo
鲍	bkuaae
盔	ypiaee
镰	lroeou
拽	kuiauu
酝	kyeeao
怡	ksaoia
菇	gwauei
搓	cuouei
醛	qyeiuo
涕	ttouae
噬	sjueei
蒜	sweeee
囱	chuaoo
愕	rsiaee
孚	fjaiee
壕	hnoeeu
鸥	riuaee
唠	ljeiau
濒	btieeu
渤	bteiau
撮	cuiaei
拇	muaaoo
琅	looaoo
呻	sjiaii
撩	lueuia
桨	jfeioo
佟	thuaoo
皿	meeeee
嘘	sjieii
襄	xfiaee
胰	kceaoo
鞠	jyuaou
泓	htaeao
蝗	heuiee
橱	cbeuei
蝠	feeiae
伶	lhuooa
倔	jhaeai
酌	vyuaoo
黯	reoeia
秸	jleiia
圳	vnuiii
绚	xcuaia
庇	bfeaua
窦	dseiao
酯	vyuaia
睦	meeiuo
屉	tbeiaa
窒	vseaei
兀	wpaaaa
樊	fbeuoo
庶	sfoooo
妓	jneiao
戎	rieuuu
岱	dhiaii
滇	dteiuo
侗	dhiaei
簸	bleiau
迸	bgoaoo
赎	seeiao
沥	lteuau
眩	xeoeaa
雏	ckuioe
凛	lfoeee
旭	xkiaee
苑	kwuaaa
撼	hueuoa
懊	rsuieu
庵	rfeuia
骇	hcoeoo
骡	lciaaa
汝	rtauee
喽	ljouau
栅	cbuaee
挎	yueuee
徙	xmieie
邱	qhaiii
冉	reeeee
蠕	reeoeu
瘾	kfaiua
峪	keuoia
蜻	qeeeia
茬	cweuei
篡	cliaeu
绊	bcouii
亢	yfuaaa
猖	ckiaia
嚎	hjoeeu
荔	lwauau
廿	nyeeee
癞	lfeiua
萤	kwiaoo
秽	hliaua
鳄	rkiaee
呛	qjuoaa
汞	gyiaoo
瞄	meeiia
攘	ruoeia
挛	lfueii
兢	jyeiia
啤	pjuiei
陇	lzeuoo
汲	jtuaoo
漉	ltoeea
寝	qsoeae
募	mwauuu
贻	keaoia
黔	qeuooa
遏	rioaoo
邯	hyaiii
酥	syueoo
蝙	beoaia
阜	fheiii
婪	lbauee
氦	hloeoo
狈	bkiauo
嗒	djeiuo
缎	dcuiua
刁	dbeeee
瞻	veuaoe
篱	lloeia
煽	sgoaao
墟	xnieii
橘	jbaoia
惋	wsooua
舵	dmooua
埠	bnuiei
尴	gpiiia
尬	gpuoui
岚	leuauo
肋	lcauuu
褶	vdaoui
潺	ctaeai
谕	kduoia
亨	hfaiii
蜓	teueao
苷	gweiee
裔	kfiauo
贿	heeuia
悍	hsiaee
蓦	mwaaee
逞	cjoaoo
於	wfuooo
迂	kooaoo
谛	ddoeia
邵	snaiii
陛	bzeaei
嬉	xneiia
刃	rnoooo
砧	vpieia
粱	ltouoo
苞	bwuaae
啰	ljiaua
猾	hkiaia
揩	yueaui
斟	vyooei
坷	yneiia
酮	tyiaei
芜	wweeaa
赦	snueoo
纶	gcuoua
馋	ckuaoo
沐	mteioo
黝	keaaau
擒	quuooe
捅	tuaoia
钛	treuoo
泵	bpiaoo
哉	zyiaee
涝	lteiau
琶	poaiaa
蝉	ceouia
缆	lciiia
傣	dheeio
缤	bcooui
孜	zzueoo
彦	kfuuuu
烹	pfoooo
怅	csueoo
砰	ppeoii
雍	kfaaui
虞	kriaee
嘈	cjeiia
栓	sbuoee
胱	gcioua
锭	drooei
痉	jfaoei
卦	gniooo
磺	hpeiia
楠	nbeiia
辙	vioeue
瓢	pyuuoo
漾	ktouoa
钊	vriiii
蟆	meeiia
匿	nieieu
札	vbaaaa
霎	suoeau
瞩	veaeui
蘑	mwoeeu
跺	djuaei
疡	kfauuu
螂	leoaai
溺	ntaeae
疹	vfuouu
缫	scaaia
臀	tbiaee
捍	huiaee
皓	hhueia
璧	bbeeoo
汛	xtaeii
惫	bkoaoo
嫦	cnioia
瑁	moiaia
瘪	bfuiuo
玳	douiea
膳	scouia
骏	jcaouo
伺	chaeia
峦	lfiaii
疚	jfuaoo
浒	htoaue
睬	ceuoei
呃	rjeuaa
肴	kjeuia
惘	wsiaou
搀	cuuaoo
涧	jtoiia
糠	ygoeae
澎	pteiuu
囤	deeaaa
祺	qdeiuo
涎	xtuiao
拯	vuaiee
殉	xpuaia
蜒	keuiao
怠	dxoaoo
牟	mxueii
曳	keuuuu
靳	jyuuii
凰	hkuiee
蔼	rwoaia
捶	cuueee
踌	cjeeei
鳍	qkeiia
佤	wheaoo
鬓	byooui
娴	xnoiei
窿	lsaiua
戊	wpoooo
躇	cjeiei
瘀	kfoeuo
厄	rpaaaa
惚	hsuaoa
悯	msoioe
拭	sueaei
剌	lyiiii
鲢	lkeaoa
峙	seeiei
哒	djeuoa
沌	dteaaa
抡	luuoua
槌	cbuioa
彝	kcoueu
驭	kcaooo
晦	hiueaa
秆	gleeii
钡	briauo
丞	czeeee
瞳	teoeia
馨	xnueia
靡	mfieie
吠	fjeuoo
邑	kjaiaa
殴	riuaao
阮	rzeeua
簌	sleiua
寰	hsiaei
踞	jjaeei
塾	sfeiee
奕	kfeuoo
镀	droeao
攫	juiaui
侃	yhiaui
琵	poeaua
褪	tdaeoa
漓	ltoeia
檀	tboeia
哧	cjeiui
茹	rwauia
褥	rdeuei
酰	xyueua
毋	wceeee
桓	hbeiae
栈	vbeeoo
靴	xyuiua
删	skiiii
碉	dpuaei
墅	seeiee
螨	meeiei
嗳	rjuoeu
驹	jcuaia
碾	npaeei
眸	meaoue
乍	vleeee
撵	nueeea
雹	buuaae
黛	dhiaoo
炫	xgoeaa
捻	nuuooa
沽	gteiia
啧	zjeeia
痪	hfuaia
赘	voiauo
唬	hjieua
宦	hseaia
憧	csoeia
蜗	weiaia
惦	dsoeie
噗	pjiiou
舷	xmoeaa
悖	bseiai
恕	snoaoo
渍	zteeia
谴	qdiaoa
腋	kcoeui
曙	siiaei
忱	csoaaa
肇	vdaeii
荀	xwuaia
郸	dgaiii
拗	nuaaau
翌	kxoeee
睫	jeeaoo
鳖	bguaee
辗	niaeei
蚌	beeeii
斐	froeoo
幔	meiaia
酣	hyeiee
隧	szouoa
厮	speiuu
锹	qrueou
耦	roiaoo
蝎	xeiaua
朔	sguaee
苓	lwuooa
狞	nkooei
蕃	bwuoia
邃	ssoaoo
蜿	weooua
饷	xkuiia
垛	dnuaei
伎	jheiao
迢	tnoaoo
栩	xbaoao
谍	ddeiei
鑫	xruouo
瞟	peeiee
詹	vkoeee
椰	kbeiai
戌	xpeeee
掖	kuoeui
禀	bfeeiu
孽	nwuiai
鞘	qyioia
渲	xtooei
篓	llouau
袅	nkoeoo
垣	kneiae
偎	whiaea
唰	sjaeii
抿	muaeaa
揍	zueeee
岖	qeeauo
矗	cyeiei
萃	cwoeuo
竺	vleeee
瀚	hteiuo
芋	kweeii
盎	reiaee
跄	qjuoaa
粕	pguiee
绽	vcooei
踉	ljoaeo
俨	kheiuu
瘟	wfiaia
缦	mciaia
菠	bwooau
缉	jciaei
蟀	seoeaa
晾	lioeia
遐	xboaoo
岑	ceuooa
裘	qyoeoo
汀	tteiii
肛	gceiee
搔	suaoia
嚓	cjooua
藓	xwuaou
糯	ngeoeu
咆	pjuaae
瓮	wjeaoo
娄	lgauee
攥	zuueaa
恬	tsueia
岐	qeeiao
坯	pneuee
莓	mwueaa
蘸	vweiui
瑙	noaaui
搪	tuoeae
柚	kbiaee
蹭	cjouia
犀	xbioue
炔	qgaeoo
珑	loeuoo
唧	jjaeai
蟋	xeuooa
龈	yraeoo
屹	keueaa
噶	gjeiia
懦	nseoeu
犊	dleiao
臻	vieeue
喔	rjaeea
珞	louaia
臆	kcoeoa
鹦	keuaee
倏	shuaeu
捺	nueuee
葆	bwuiia
懵	mseiia
嗖	sjuiao
偕	xheaui
衅	xhouii
笠	lloeee
侈	chuaua
坍	tnuaee
腆	tciauo
翡	fraoao
叼	djaeee
颐	kieuia
楷	jbeaui
擂	lueoia
舔	tleeio
憬	jsiaoe
筏	fluiea
垢	gnuuia
肮	rcoeua
帚	vbiaii
曝	biiaei
镍	nruiei
骥	jcieia
侠	xheooo
嗤	cjaiia
喏	njeieu
凋	dfuaei
舜	sjuaea
崛	jeaeai
沮	jtiaee
壑	hreiee
箔	blooui
臼	jheeee
竣	jfaouo
殆	dpaoia
掐	quuaui
穹	qsaeaa
鹉	wouaee
箫	xlaeoo
鸠	jkuaee
芥	gwuoui
燎	lgeuia
榻	tbiaao
蕨	jweuou
夭	kloooo
诣	kduaia
惺	xsiaue
霄	xuioia
磊	lpeueu
炙	vkouuo
蹑	njeiao
楂	cbeiia
琦	qoeuei
僮	thoeia
祁	qdaiii
鞑	dyeuoa
榕	rboouo
荪	swaiiu
婢	bnuiei
踊	kjaoia
吝	lfiaee
矜	gxuooa
娅	kneiee
祟	szeeiu
娣	dnouae
跛	bjauao
蛹	keaoia
笙	slueee
赃	zeoeei
妊	rnueee
锢	griaei
韫	woiaia
荤	hwoaea
羁	jeeiaa
捋	luuoei
攒	cuueia
瞿	jeuioe
饺	jkoeuo
腼	mceuee
奚	xjaaeu
帷	weuioe
蟾	ceuaoe
蛀	veoeee
抨	pueoii
婕	jneaoo
哝	njoaoo
糜	mfouoo
杈	cbaooo
馍	mkeiia
粼	lgaaaa
悻	xseiou
槛	jbiiia
漩	xtoeue
兮	xjeaaa
赁	lhiauo
炬	jgeaae
蜷	qeouaa
铬	gruaia
擎	qwueii
鼾	hheeii
髻	jyeiia
樟	vboeei
蛎	leeuea
伢	kheauu
仕	sheiee
佧	yhieoo
焘	dooooo
槟	bbooui
跤	jjoeuo
缰	jceiae
悸	jsueai
佼	jhoeuo
姗	snuaee
曦	xiouue
隍	hzuiee
隅	kziaoo
诙	hdeuou
镑	broeoe
猕	mkaeua
恃	sseiei
妩	wneeaa
匾	bioaia
蜥	xeeiuu
迥	jeoaoo
娓	wnaeue
锚	mreiia
淞	steiuo
琪	qoeiuo
胥	xziaee
痢	lfueii
癖	pfaeoe
芍	swuaoo
渝	ktuoia
骋	cciaea
螳	teioei
阑	laeioo
梓	zboeei
螃	peoeoe
娠	sneuee
瘠	jfoeia
辘	lioeea
箕	jleiuo
忏	csueii
搐	cuoeia
妾	qfauee
汐	xtuaoo
篆	vlaaeu
撂	luiaua
哽	gjeioo
甥	sliaau
咄	djaiii
豌	weooua
铮	vruaae
拄	vuoeee
粽	zgooee
纫	rcauoo
渭	wtiaia
褒	bfuiua
耙	boaiaa
翕	xhaoao
沓	dtiaee
汕	stiaii
掰	buuoue
甄	vyeaoo
睿	rriaee
嵩	seoeia
憔	qsuioo
巅	deeieu
驿	kcaoee
箩	lliaua
悴	csoeuo
膈	gceiae
忖	cseioo
忡	csiaii
霓	nuuiua
瞌	yeeiia
镐	groeia
琉	looeui
瑾	joeiia
钴	greiia
桅	wbuaaa
萼	rwiaee
媛	knuoee
吮	sjaoua
篙	gloeia
篝	gleeia
锵	qroeua
踵	vjueee
祛	qdeiao
奄	kpiaaa
丐	gyaaaa
臧	cpeaia
耷	dpeiee
浏	ltoeii
毗	peeaua
磋	cpouei
擞	suouue
纂	zlaaiu
叱	cjuaaa
淙	ctooee
彗	hoaeee
钨	wruaee
蹙	cpiaie
谚	kdoeuu
熵	sgoeia
遁	dmoaoo
滕	tcouio
枷	jbauia
敝	bgueoo
虱	sauioo
涮	staeii
馅	xkuaui
冗	rduaaa
蟒	meeiei
盹	deeaaa
嗔	cjeiuo
惴	vsiaeu
萦	kwaaiu
藕	rweeia
埂	gneioo
赡	seuaoe
鳗	mkiaia
薰	xwueoo
嚏	tjeiia
摒	buaeou
彤	tkuuuu
蘖	nwuiei
跷	qjeaeu
腭	rciaee
泾	jtaoei
钵	breiee
窠	ysiaoo
伫	vhooee
谟	mdeiia
蚪	deooei
诅	zdiaee
玺	xkeeoo
缨	kciaau
儡	lhiaia
蝌	yeueoo
祯	vdieia
蛐	qeiaee
亘	geiaee
冕	meuaia
暨	jbiaee
怦	pseoii
佯	khouee
跚	sjuaee
匡	yieeee
坳	rnaaau
诃	hdeiia
晖	hioaea
楣	mbaiia
蹂	rjaoei
泯	mtaeaa
觑	qriaua
邬	wkaiii
掸	duouia
娩	mnuaia
锗	vreiia
憩	qloaoo
匍	pkeioo
仨	sheeee
傀	ghuiao
耘	koeeao
镭	lreoia
讪	sdiaii
殃	kpiaoo
匐	fkeiae
啕	tjuaue
筱	xluiue
颚	rjeuia
漱	steiua
瞭	leeuia
畦	qeeiei
獗	jkeuou
唏	xjuoeu
犷	gkoeuu
熠	kgaoui
咂	zjeaia
侥	jheaeu
桉	rbooau
勐	mzauuu
黍	sluoio
盅	veiaee
蹒	pjeiei
幌	heiaio
寐	msaiee
囿	keeuia
慑	sseiao
筝	vluaae
闰	raeeee
貂	djauia
蔷	qweiia
谏	jdeioo
癫	dfeieu
佬	lheiua
噎	kjeiei
唆	sjaouo
袒	tdiaee
麸	foeeoo
蚜	keeauu
圩	wneeii
酞	tyeuoo
昵	niaeua
羹	ggoueu
咿	kjuiae
俐	lhueii
蹿	cjooia
梏	gbueia
潼	ttoeia
扈	hdiaai
咛	njooei
恤	xsuiee
蔺	lwoiui
谤	bdoeoe
聆	lyuooa
惬	qseaeo
撅	jueuou
榄	lbiiia
沣	fteeii
蜴	keiaua
蔫	nweiea
橄	gbaeue
瞰	yeaeue
瑜	kouoia
痞	pfeuia
绛	jcuaea
鸳	kkuaee
唷	kjoeia
柠	nbooei
撬	quueue
痘	dfeiae
掂	duoeie
椿	cbeeia
镖	breiee
匕	bkaaaa
嫡	dnoeia
腌	rceuia
岷	meaeaa
匝	ziiaii
噙	qjuooe
矾	fpuaoo
躏	ljeioi
覃	qyiaei
惆	csuaei
漪	ktuaeu
浜	btuiuo
檬	mbeiee
皑	rhiaae
镊	nreiao
楔	xbeeeu
噘	jjeuou
嗐	hjooee
厩	jpaeea
肽	tceuoo
蒿	hwoeia
羟	qgaoei
桎	vbeaei
睑	jeuooo
褚	cdeiia
赂	leuaia
蚴	keaaau
冢	vdeuoo
徨	hmuiee
抠	yueauo
硼	ppuaua
鸯	keuaee
粑	bgaiaa
缪	mcaouo
垠	knaeoo
掣	clueii
掇	duaoao
蹋	tjiaao
铿	yriiei
赳	jnaiii
蛔	heiaia
铐	yreiea
镯	vriaua
涸	htiaei
蹼	pjiiou
翎	lhaoao
萘	nweuee
咔	yjieoo
煦	xioooo
囔	njeiia
螅	xeuioa
匮	giiaia
膺	kfiaee
痊	qfuoee
茁	vwaiii
颞	nyeuia
矶	jpuaaa
晔	kiuiei
辄	vieiaa
沏	qteaau
卅	spiiii
枇	pbeaua
铂	bruiee
龛	yheuoo
杷	pbaiaa
炖	dgeaaa
韶	sfauia
谧	mdoaia
麂	jfuaaa
韭	jreeee
阈	kaeaia
僰	byuooo
堰	kneaia
诽	fdieie
醚	myouoa
皎	jhoeuo
圭	gneiee
妞	nnaiee
揿	quueua
蛟	jeoeuo
樵	qbuioo
绮	qceuei
忐	troaoo
帛	bhiaii
怏	ksiaoo
阂	haoeoo
桢	vbieia
茉	mweeoo
锨	xruuua
臌	gceiei
瘴	vfoeei
舀	kjuiee
睾	gheiou
鞅	kyiaoo
岌	jeuaoo
斓	lfoiei
彷	fmoeuu
铣	xrueua
绯	fcieie
刽	ghiiii
臃	kcoeaa
嶙	leouua
俾	bhuiei
闵	maoeoo
螟	meoaia
坞	wnuaee
酉	kyeeee
俟	qhaoue
啷	ljoaai
骸	heoeoo
嫔	pnooui
逍	xwoaoo
瘸	qfauia
倭	whueau
朕	vcouee
掳	luieau
蓟	jwuaii
拈	nuieia
霹	puaeoe
怆	csuoaa
笆	blaiaa
礴	bpeioo
脐	qcoeui
蚤	zxiaoo
狰	vkuaae
猝	ckoeuo
逵	dnoaoo
褴	ldiiia
飒	sfuauo
牦	mlueaa
忑	tyoaoo
爨	cheieu
邸	dkaiii
溥	pteiei
沂	ktuuii
咎	jkiaee
渎	dteiao
蓿	xwooui
栉	vbeiai
鬃	zyooee
涟	lteaoa
锂	lriaee
疱	pfuaae
俚	lhiaee
汾	ftuoau
嘹	ljeuia
勰	xniaoa
亟	jzeeee
惮	dsouia
螯	roiaoo
抉	juaeoo
濡	rteoeu
蹴	cjoeeu
釉	kjiaee
淅	xteiuu
噼	pjaeoe
啮	njieuo
挝	wueioa
讹	rduiua
腧	scuoia
馄	hkiaea
淼	mtiaia
臊	sciaei
刍	ckaeee
雳	lueuau
啬	syiaia
烽	fguaee
戟	jyeaoo
鳌	rouaee
苜	mwiaee
啶	djooei
喋	djeiei
烬	jgaeoo
谙	rdoeia
榈	lboiia
堑	qieiee
冽	lfeuii
缮	scouia
蚱	veueee
裨	bduiei
晏	kiooau
恽	ksoaea
燧	sgouoa
蝈	geiaee
荚	jweooo
颧	qweuia
轲	yieiia
沱	ttooua
毓	kloeui
蜚	friaoo
戛	gpeaoo
绫	lceiuo
嚅	rjeoeu
翟	dxuioe
潦	lteuia
戍	spoooo
偌	rheieu
饨	tkeaaa
蜍	ceuoee
媲	pnuiea
坂	bnuuao
俑	khaoia
嗥	hjuieu
殡	bpooui
娼	cniaia
泞	ntooei
漳	vtoeei
珀	pouiee
懑	mtoaoo
菁	jweeia
噩	ryiaia
胭	kciaeu
铎	draoee
敖	roueoo
濛	mteiee
悚	sseioo
纭	kceeao
褛	ldouau
滦	ltoeei
蹊	qjuoaa
榷	qboaoe
鹭	ljuaee
舢	smiaii
敕	cyueoo
孰	sfuaoo
蚶	heeiee
颏	yfeuia
粳	jgeioo
亵	xfeiua
啜	cjaoao
硒	xpeiee
幡	feuoia
弩	nnaeaa
翱	rhaoao
阱	jzeeii
镂	lrouau
夔	yguiuo
腱	jcaeao
扉	fdieie
涣	htuaoo
嗫	njeiao
寮	lseuia
竑	hfeuao
桧	gbuoee
毽	jlaeao
馁	nkuoau
羧	sgaouo
箍	gleiei
摞	luiaaa
碴	cpeiia
黠	xeeiia
呓	kjeiaa
镣	lreuia
拷	yueiea
砷	spiaii
扦	quueii
谔	rdiaee
膘	bceiee
呷	xjiaii
胫	jcaoei
拮	jueiia
孑	jzeeee
冼	xfueua
讷	ndiaoo
嘁	qjeuie
篾	mliaeu
踽	jjuioo
铆	mruaai
卯	mkaiii
笺	jleeoo
瑕	xoaeae
垅	lneuoo
羚	lguooa
疽	jfiaee
唢	sjioia
氖	nlauuu
髭	zyieua
谒	kdiaua
裱	bdeeua
辕	kieiia
泗	stiaee
诛	vdueoo
遽	jroaoo
獭	tkeiua
麝	sfuiei
跻	jjoeui
诘	jdeiia
犟	jbueii
燮	xfaooo
砣	tpooua
诲	hdueaa
貅	xjuiei
裆	ddioae
噤	jjeiee
赈	veeuee
踮	djoeia
髯	ryiaee
霭	ruoaia
榔	lboaai
皙	xbuiee
谆	vdoeai
熹	xnoooo
喙	hjaaeu
酗	xyuoai
潢	gteiia
铨	qruoee
甬	kxiaii
揖	kuiaei
幺	kcoooo
饽	bkeiai
荃	qwuoee
盂	koiaee
弋	kioooo
懋	mboaoo
绦	tcuaei
瘁	cfoeuo
茭	jwoeuo
阖	haeiia
讴	rdeauo
恙	kgoaoo
镢	jreuou
掬	juuaou
峋	xeuaia
暄	xiooei
藐	mwuoui
沅	kteeua
濮	ptuiii
隽	jhauuu
鸾	lfuaee
壅	kfeiee
侏	vhueoo
孺	rzeoeu
疸	dfiaee
恣	zfoaoo
缥	pceiee
喟	yjiaia
睐	leeooo
皋	gheuei
狍	pkuaae
戮	lxeaoo
琥	hoieua
迨	dxoaoo
噔	djaoei
氰	qleeia
瞠	ceioei
鳙	kkoeae
凇	sfeiuo
嫣	kneiea
迩	rkoaoo
蛄	geeiia
谑	xdieea
轼	sieaei
泸	ltieae
骁	xceaeu
澍	steiei
仄	zpuooo
眈	deoaaa
遨	rooaoo
萱	xwooei
籁	lleiua
雉	vluioe
昙	tieeao
缄	jceuia
婀	rnaiei
舐	sluaaa
柞	vbueee
锺	vrueee
恪	ysuaia
蟑	veoeei
蛰	vuiaoo
洄	htiaia
恿	kxoaoo
浃	jteooo
犄	jleuei
簪	zleaia
赓	gfiauo
锑	trouae
桠	kbeiee
貔	pjuiea
偻	lhouau
舂	couiee
呶	njauao
阡	qzueii
釜	fjeeee
痿	wfueau
醮	jyuioo
鳅	qkueou
阉	kaeuia
疝	sfiaii
嘧	mjooia
挞	tueuoa
腚	dcooei
痨	lfeiau
逦	leoaoo
胛	jciaii
湮	kteiei
嗷	rjeeue
钽	triaee
怂	shoaoo
汩	gtiaee
衢	qmiaee
蜇	vuiaoo
疣	kfeuoo
滓	ztoooe
趄	jniaee
熨	kbouuo
癣	xfuaou
禺	keoooo
摈	buooui
汊	ctaooo
霆	tuueao
霏	fuieie
蜢	meaiia
谘	zdoeia
氩	kleiee
昕	xiuuii
辍	ciaoao
侬	nhoaoo
诋	dduaoo
崴	weeuau
荠	jwoeui
蹩	bgiaie
荟	hwuoee
轶	kiueoo
豢	hgeuoo
窸	xsuooa
蛊	geiaee
丕	ppeeee
搽	cueiuo
腈	jceeia
蜃	spiaoo
坩	gneiee
阙	qaouua
涓	jtiaia
嗵	tjaooa
羲	xgueea
筵	kluiao
骈	pcouee
呸	pjeuee
轱	gieiia
稞	yliaoo
砝	fpeiao
訇	hkoeee
嶂	veoeei
痈	kfuaii
埚	gniaia
蛆	qeiaee
雯	wuoeoo
垭	kneiee
牍	dheiao
徭	kmuoue
怵	cseioo
荞	qwueui
迤	kloaoo
脍	ycuoee
趔	lneuii
涪	ftoeia
荼	twuoee
孛	byaiee
踹	cjiaeu
嵘	reeiei
俸	fheeee
赭	vneiia
滁	ctaiuo
潴	vtuaei
徕	lmeooo
泮	ptouii
剽	pyiiii
殓	lpuooo
钗	craooo
霰	xueiue
阪	bzuuao
杞	qbaeaa
枸	gbuaia
牒	dheiei
懿	knoeoa
镌	jruiau
铛	crioae
绉	vcuaae
芩	qwuooa
疵	cfieua
孪	lfaiee
鲑	gkeiei
扪	muoiaa
窣	ssoeei
埝	nnuooa
飕	skuiao
瓠	hpuuoo
壬	rleeee
婊	bneeua
铡	vriaii
饯	jkeeoo
猬	wkiaia
诂	gdeiia
祗	vduaoo
湄	mtaiia
濂	ltoeou
瀛	ktoeia
茜	qweiee
睽	yeaoee
锉	cruoei
娑	stauee
撷	xueieu
髅	leouau
旯	liuaaa
锷	rriaee
椽	cbaaeu
斫	vpuuii
琛	cooaei
卞	bfoooo
蹉	cjouei
璀	coiaui
邝	yfaiii
裟	stoeoo
袈	jnoeoo
垓	gnoeoo
珧	kouoau
铠	yriaae
钎	qrueii
铯	sruaai
囡	neauee
橹	lbuaia
啻	cfiaee
蓑	swoeia
恻	csiaii
芷	vwieee
剁	dkiiii
旮	gkiaee
霾	muuoia
阗	taeiuo
悒	ksiaai
媾	gneeia
桕	jbuiee
蹶	jjeuou
奘	zzeuoo
仃	dheiii
嗝	gjeiae
梿	lbeaoa
氅	cwueaa
腴	kcuioo
佝	ghuaia
迳	jxoaoo
擀	gueiuo
町	deeiii
莼	cwaaea
磬	qneuia
绺	lcuaia
哐	yjeaee
宕	dseuia
孀	sneoei
柘	vbeuia
咫	vbiauo
鄱	pjaiii
诿	wdueau
蜈	weiaee
弭	mbeiee
垩	ryeiee
恸	tseeau
筲	slioia
姣	jnoeuo
踝	hjiaoo
蚣	geuoao
睨	neuiua
旌	jfueue
谲	jdaoia
饬	ckueau
鸨	bkuaee
陲	czueee
洵	xtuaia
璜	hoeiia
氘	dluiii
杳	kbiaee
浚	jtaouo
锟	yriaea
牯	gleiia
痂	jfauia
戾	ldeuoo
麒	qfeiuo
镉	greiae
绀	gceiee
痣	vfeioa
忪	ssuoao
黏	nlieia
囵	leuoua
颦	pruiei
赊	seuoee
蟠	peuoia
癸	gxeeoo
劾	hfauuu
胯	yceuee
鲟	xkaeei
赕	deouou
夥	heuaua
踅	xuiaie
袤	mfaoua
佚	dhueoo
抻	cuiaii
疥	jfuoui
涔	ctiauo
罹	leooui
囫	heuauu
黜	ceaiii
辊	giiaea
碓	dpuioe
龋	qruioo
虻	meoeaa
璞	poiiou
谩	mdiaia
蹓	ljuaia
孬	npauai
愠	ksiaia
馥	flueia
膑	bcooui
砥	dpuaoo
洱	rteiee
菖	cwiaia
咣	gjioua
栎	lbuaoo
鲮	lkeiuo
绾	wcooia
嗟	jjouei
缈	mciaiu
骷	yeeiia
崮	geiaei
稷	jliauo
邕	kciaai
邛	qyaiii
猷	kgeuoo
咩	mjouee
莠	kwueau
秫	sleioo
揄	kuuoia
纨	wcuaoo
砻	lpeuia
帧	veieia
鹄	hluaee
揶	kueiai
漕	cteiia
颉	jneuia
嬗	snoeia
酪	lyuaia
镓	jrooeu
胄	veiaee
蝼	leouau
顼	xoeuia
蓓	bwuioe
豺	cjeiuu
奁	lpeauo
钋	priooo
鏖	rfuoee
徇	xmuaia
窕	tsuoau
噌	cjouia
钍	treiee
闩	saeeee
榭	xbuiei
忒	tioaoo
塍	ccouei
栾	lfeioo
巯	qxoeui
绌	ccaiii
疖	jfaiii
嘭	pjeiuu
洮	ttuoau
甙	dieiee
瓤	rfuuoo
鸪	gyuaee
鹧	vfuaee
昶	cdiaee
飓	jkiauo
锲	qreeeu
盥	ghiaee
窈	ksaaau
靼	dyiaee
颛	veeuia
浔	xtaeei
荥	xwiaoo
呤	ljuooa
臾	khoooo
颔	hheuia
煜	kgiaoe
鞣	ryaoei
咤	vjooue
舨	bmuuao
猥	wkiaea
喁	kjiaoo
唑	zjuoei
蠡	lciaia
搡	suaoei
煅	dguiua
淄	ztaaia
摺	vuaoui
兖	kfuoua
峥	veuaae
呲	cjieua
啾	jjueou
掮	quoaia
榛	vbeeue
硷	jpuooo
钼	mriaee
荸	bweiai
颀	qmeuia
磐	pmeuia
鹑	cfuaee
诩	xdaoao
柩	jbeaua
黢	qeaouo
俪	lheiao
饪	rkueee
姘	pnouee
艄	smioia
苕	swauia
箸	vleiia
攸	khueoo
佘	sheeiu
挲	stueii
矽	xpuaoo
瓒	zoueia
孳	zgaiee
璐	loiaua
翦	jgaoao
杵	cbueii
桀	jkeioo
茏	lweuoo
谵	vduaoe
妍	kneeii
檄	xbuiue
暹	xioaoo
镕	rroouo
纣	vceioo
鲷	dkuaei
忻	xsuuii
醺	xyueoo
婺	wxauee
潍	wtaaui
潞	ltiaua
吡	bjeaua
碣	jpiaua
郗	xjaiii
骰	seuaao
鳊	bkoaia
岫	xeiaee
笸	pleaia
汴	btoeoo
忸	nsaiee
珲	hooaea
蕙	hweioa
怩	nsaeua
鹞	kjuaee
槃	pmeioo
墒	snoeia
咝	sjaaee
濯	vtaoui
褓	bduiia
襁	qdaeia
峒	deiaei
濠	htoeeu
腓	fcieie
脒	mcouoo
耆	qyiaee
谄	cduaui
馊	skuiao
咻	xjuiei
鳔	bkeiee
凫	fkuaaa
柽	cbaoei
犸	mkaaee
爿	pzuuuu
巳	sbaaaa
驸	fcuiei
俵	bheeua
邈	mjoaoo
羿	kxeuii
熜	cguioa
恫	dsiaei
椴	dbuiua
蠖	heeiui
铤	drueao
澹	dtuaoe
捱	rueuei
唿	hjuaoa
嫖	pneiee
龊	criaie
啐	cjoeuo
莞	gwooee
钒	fruaoo
汶	mtoeoo
嚯	hjeoui
偃	kheaia
娲	wniaia
煊	xgooei
蔻	ywooee
渚	vteiia
遛	lkoaoo
赅	geoeoo
蛴	qeoeui
螬	ceeiia
茯	fwuieu
帼	geiaee
仞	rhauoo
剜	wsiiii
炷	vgoeee
煨	wgiaea
棣	dbaeoo
迺	nyoaoo
湟	htuiee
籼	xgiaii
畿	jciaee
稗	bluiei
鲲	ykiaea
笞	claoia
爰	kjeeao
碲	dpoeia
蹚	tjioei
舫	fmoeuu
聒	gyueia
龌	wraeea
茗	mwuaia
葳	wweuau
藜	lwueuo
哔	bjeaei
棂	lbaeou
忾	ysueaa
钰	kreeoo
埕	cniaee
沤	rteauo
桡	nbeaeu
蓖	bwuiea
飚	bkouou
沔	mteiaa
焙	bgoeia
莘	swoeei
缙	jceiia
鹂	leuaee
垧	snuiia
癯	qfiaui
皈	ghuuao
锃	zriaee
唁	kjoeee
栀	vbuuaa
璨	coieou
玷	doieia
畈	feuuao
烩	hguoee
靛	doooei
斛	hkooei
轭	rieuaa
戕	qzeaoo
祐	kdeuia
衩	cdaooo
徜	cmioia
涞	lteooo
绔	yceuee
璎	koiaau
钚	breuoo
砭	bpuooo
碛	qpeeia
獾	hkeiia
嗄	sjeuua
夙	skeuoo
闿	yaiaae
箧	qleaeo
铰	jroeuo
氚	cluiii
嵋	meaiia
骊	lceiao
圪	gnueaa
啉	ljeiei
淇	qteiuo
讣	fdiooo
犍	jlaeao
闾	laiaia
旃	vfueua
彧	kiiaee
嘌	pjeiee
糍	cgouaa
摁	ruiaoa
橼	kbaaaa
噫	kjoeoa
鸵	tkooua
骧	xcoeia
泅	qtiauo
伧	chuoaa
铱	kroeoo
皴	cxauao
榘	jleioo
谡	sdiauo
佗	thooua
胤	kuaaaa
鹌	rpuaee
佻	thuoau
潸	steiia
鲈	lkieae
砺	lpeuea
耒	looooo
韪	wieeii
孱	cbaiai
璠	fouoia
倜	thuaei
葺	qwiaei
螫	sniaoo
飙	bpuauo
罄	qnueii
帏	weeeii
崂	leeiau
铧	hruiei
喑	kjoeia
嘣	bjiaua
慵	ksoeae
趸	diiaie
酐	gyeeii
焖	mgoioa
胝	vcuaoo
鳝	skouia
肓	hfiaee
鸶	scuaee
撸	luuaia
鲻	zkaaia
炘	xguuii
镞	zroeue
赧	nnaiao
謇	jsoeee
弈	kfeuii
嘤	kjiaau
媵	kcouau
鹘	geuaee
鹬	kxuaee
霁	juoeui
跶	djeuoa
绶	scuoao
蛉	leuooa
鼹	khiaoo
幂	mdiaeu
贰	rieeia
祜	hdeiia
衽	rdueee
罂	keueii
蓼	lwaouo
苋	xwiaua
徉	kmouee
羯	jgiaua
胴	dciaei
氤	kliaeu
炀	kgauuu
晁	ciuoau
芪	qwuaaa
骅	hcuiei
屙	rbaiei
箓	llaeio
氲	kliaia
逅	hmoaoo
邂	xkoaoo
觐	jyiaua
蛳	seiuei
缜	vceiuo
茴	hwiaia
陂	bzauao
蜊	leueii
钿	driaee
鬻	kbeiae
剐	gjiiii
诌	vduaae
妁	snuaoo
壹	kneiae
砒	ppeaua
钏	cruiii
搧	suoaao
吋	cjeioo
菟	twuaoo
芗	xwaauu
暧	riuoeu
黧	lliaoo
呣	mjaaoo
晗	hiuoia
骠	bceiee
浣	htooee
痫	xfoiei
弁	bxeuii
哞	mjaoue
淖	ctieia
衮	gfuoua
璟	joiaoe
邳	ppaiii
昊	hieeoo
渥	wtaeea
褡	ddeiuo
趿	tjuaoo
钹	breuao
莴	wwiaia
鲀	tkeaaa
蹰	cjeuei
崃	leeooo
娌	lniaee
妯	vniaee
龇	zrieua
銮	lfuoee
钤	qruooa
脲	ncaeia
鲵	nkuiua
肄	kkaeii
窨	xsoeia
痱	ffieie
贲	byiauo
胼	pcouee
鲂	fkoeuu
铌	nraeua
菽	swieao
谗	cduaoo
坌	bjeiee
祇	vduaaa
鱿	kkeuoo
葩	pwuiai
镟	xroeue
幄	weaeea
蒴	swouua
罅	xlieuo
珙	goeiuo
嵇	jleuia
酊	dyeiii
貉	hjuaia
谶	cduoie
陉	xzaoei
淬	ctoeuo
惇	dsoeai
卟	bjiooo
猞	skuoee
邺	kqaiii
滹	htieuo
翳	kpaoao
瘙	sfaoia
疔	dfeiii
阚	haaeue
髁	yeiaoo
蓊	wwuoao
莅	lwuioe
傩	nhaoui
谀	kdueoo
蔸	dwuiua
夯	hpauuu
癔	kfoeoa
馀	kkuoee
犒	yloeia
氙	xliaii
馔	vkaeei
缢	kcouia
辎	ziaaia
讧	hdeiee
挈	qoueii
嗪	qjeeue
簖	dlouuu
嵴	jeoeia
珂	yoeiia
滂	ptoeoe
铷	rrauia
孓	jzoooo
穑	sleiia
鳏	gkiaiu
镳	broeoo
殇	spueau
瞑	meoaia
瘘	lfouau
琨	yoiaea
靥	kpeuee
圹	ynoeuu
瞽	gniaee
畚	bxeuia
湫	jtueou
艮	gboooo
鹜	wxuaee
奂	hkiaoo
姹	cnooue
讦	jdeeii
屌	dbiaia
繇	kjuaiu
屐	jbuuei
钺	kreaoo
噻	sjooei
蝮	feueia
诰	gdueia
笤	tlauia
刈	kjiiii
坨	tnooua
恁	nhoaoo
甾	zciaee
喹	yjeuei
堞	dneiei
猁	lkueii
襞	bboeoo
巉	ceuaua
恹	kseueu
瘿	kfiaau
茔	kweiee
楹	kbauia
蚨	feeeoo
嵬	weuiao
璘	loouua
篼	dluiua
蒺	jwoeue
蠓	meeiee
噱	jjieeu
鄯	sgaiii
脘	wcooee
袂	mdaeoo
聿	kbiiii
篌	hluiae
泔	gteiee
鹫	jfuaee
觊	jeiaua
笈	jluaoo
箜	ylooei
轳	liieae
瘢	bfuuua
仂	lhauuu
纡	kceeii
胪	lcieae
螽	vkiaia
叁	sxeeee
樽	zbouei
菡	hwaiai
诠	qduoee
袢	pdouii
飨	xcuooa
苻	fwuiei
槁	gboeia
蘩	fwueaa
踟	cjueia
豕	spoooo
涿	vteuoo
苣	jweaae
跖	vjeuia
藁	gwoeei
蠹	dyiaia
栊	lbeuoo
歆	xfuauo
橛	jbeuou
獠	lkeuia
呋	fjeeoo
侩	yhuoee
踯	vjouai
逡	qxoaoo
罔	weouoe
聩	yyiaia
珩	houuee
糅	rgaoei
廪	lfoeee
佥	qhooee
谰	ldoiei
檩	lboeee
嵊	seueie
谥	sdouia
玮	woeeii
炅	giouuo
蹁	pjoaia
铄	sruaoo
驷	sciaee
郢	kjaiii
岙	rliaii
鄠	huaiii
阏	raoeuo
鹳	gwuaee
裾	jdaeei
綦	qyaaiu
珏	joeeoo
苫	swieia
饕	tjuooa
玑	jouaaa
魆	xheaoo
镬	hreiui
罘	feeuoo
畹	weooua
镠	lraouo
髋	yeooei
肱	gceuao
碜	cpaouu
莆	fweioo
鄞	kyaiii
旖	kfueeu
弑	sjeaei
悌	tsouae
蒽	rwiaoa
塬	kneuui
鸢	kiuaee
竽	kleeii
箴	vleuia
嗉	sjeeaa
鸷	vuuaee
痼	gfiaei
怄	rseauo
馑	jkeiia
伛	kheauo
稃	fluoai
鬣	lyaaia
洹	hteiae
龉	kreiia
蛭	veeaei
觎	khiaua
旎	nfueae
锶	sriaoa
齁	hhuaia
鼬	khiaee
揆	yuaoee
鲣	jkiiei
搦	nuaeae
龃	jriaee
诨	hdoaea
筠	jleiua
虢	gjieua
噹	djioia
僳	sheiou
獐	vkoeei
撺	cuooia
苡	kwaouo
郓	kdaiii
铋	broaoo
铍	prauao
躅	vjiaua
锴	yreaui
芮	rwiaoo
薮	swouue
俎	zhiaee
钫	froeuu
忤	wsueii
纾	scaoii
柢	cbuaoo
琰	koouou
疠	lfeauu
逋	byoaoo
祚	zdueee
掼	guaaia
僖	xheiia
枭	xkeioo
郯	tgaiii
昴	miuaai
氡	dluaoo
鹕	hyuaee
逶	wloaoo
圜	heiaei
儆	jheiue
悱	fsieie
邋	lcoaoo
啁	tjuaei
虬	qeaaaa
榉	jbooee
秕	bleaua
粜	tzouoo
氪	yleiia
髡	yyeuaa
鹈	tguaee
琮	coooee
芾	fweiii
篑	yliaia
缬	xceieu
毖	bioaoo
舛	ckeaii
蚰	keiaee
嗲	djuoua
胍	gcuuoo
裢	ldeaoa
哚	djuaei
囹	leuooa
擤	xuuiia
圄	keeiia
橇	qbueue
跎	tjooua
倨	jhaeei
莨	lwoaoo
鳕	xkeoae
飑	bkuaae
楫	jbiaei
欹	qpuauo
蠼	qeiaui
箨	tleiao
腠	cceeee
螋	seuiao
澥	xtuaau
沆	htoeua
羰	tgiaeu
赝	kpiauo
锆	grueia
枳	vbiauo
媪	rniaia
幛	veoeei
哓	xjeaeu
砦	vreuia
鲴	gkiaei
郧	kjaiii
棹	vbieia
麋	mfouoo
偈	jhiaua
禳	rdoeia
圮	pnaeaa
愎	bsueia
缂	yceiia
錾	ziuoee
诳	yduaee
鲶	nkuooa
鸹	gluaee
荏	rwuiue
欤	kiuauo
洫	xtuiee
髀	beuiei
蹀	djeiei
鳟	zkouei
衾	qhoeoo
磙	gpoeuo
椁	gboeai
岬	jeiaii
琊	koeaai
戆	gfoaoo
傈	lheiei
僭	jheaia
瓯	rieaoo
呔	djeuoo
诤	vduaae
瀣	xtieie
吔	kjaiaa
缛	rceuei
槭	qbeuie
亳	bfueaa
碚	bpoeia
曜	kiaoui
唳	ljoaeu
襦	rdeoeu
骛	wxaaee
甑	zgeaoo
鲇	nkieia
廛	cfiauo
吲	sjaeii
龢	hhueoo
刎	wkiiii
愫	sseeaa
岢	yeeiia
杲	gieioo
遒	qgoaoo
狙	jkiaee
酩	myuaia
屣	xbuuie
捭	buuiei
帙	veueoo
餮	tpuooa
跗	fjuiei
褙	bdieia
篦	bluiea
呎	cjaeoo
棰	cbueee
阕	qaaoee
阆	laoaoo
笳	jlauia
溧	lteiei
睇	deouae
黩	deeiao
魇	kpuiao
荨	qwaeei
歙	shuauo
矍	jeuiao
鲛	jkoeuo
劭	snauuu
镧	lroiei
潋	ltuoue
楝	lbeioo
泱	ktiaoo
伉	yhoeua
倮	lhiaoo
逖	tkoaoo
滟	kteeua
縻	mfaaiu
骶	deuaoo
螈	keeuui
蝾	reeiei
阇	daeiia
滢	kteiee
璇	xooeue
痔	vfeeei
诮	qdioia
娆	rneaeu
鳜	gkeuou
帔	peauao
麇	jfueoo
擢	vuaoui
锏	jroiia
闳	haeuao
萋	qweaau
钜	jreaae
啭	vjeaee
缣	jcouoo
讫	qdueaa
汨	mtiaee
樨	xbaeio
楸	qbueou
矬	cluoei
岿	yeiuae
遢	tioaoo
侪	choeui
叵	piiaee
糁	sgaoeu
钯	braiaa
宸	cseuee
桷	jbuaua
柈	pbouii
啖	djouou
铙	nreaeu
粲	crouoo
衄	nhaiee
狎	xkiaii
睥	beuiei
傥	thioua
铢	vrueoo
菘	sweiuo
瑷	rouoeu
疬	lfeuau
瘰	lfiaaa
篁	hluiee
厝	cpeiia
羸	lfiaua
鬟	hyiaei
牾	wleiia
郴	cbaiii
珈	joauia
艿	nwauuu
珐	foeiao
碇	dpooei
茌	cwuiei
溟	mtoaia
鏊	rouoee
犴	hkeeii
铓	mreioe
骜	roaaee
囝	jeaiee
怿	ksaoee
妪	kneauo
颎	jkeuia
乜	mcaaaa
耧	loouau
蠲	jgiaua
嗑	yjeiia
圻	qnuuii
辔	pciaee
殒	kpiaia
瘃	vfeuoo
埙	xniaia
褫	cduuie
啵	bjooau
怛	dsiaee
榧	fbeaie
箪	dlouia
醴	lyiaei
戗	qheaoo
佞	nheeau
蛱	jeeooo
鲳	ckiaia
骞	qsaaee
眦	zeieua
溏	ttoeae
穰	rloeia
茕	qwaeii
邠	bjaiii
阒	qaiaeu
磡	ypeiau
牖	khoaei
诟	gduuia
虿	ciiaoo
糌	zguaia
磴	dpaoei
庖	pfuaae
徵	vmiaue
拊	fuuiei
苄	bwoeoo
铳	croeua
剋	yyiiii
笱	gluaia
畛	veuouu
稔	rluooa
琤	couaae
偬	zhuaoa
癜	dfaeua
翮	heaoao
惝	csioia
玕	goeeii
贽	vuiauo
酽	kyeiuu
鸱	ckuaee
醍	tyiaei
焱	kgouou
茀	fwaeii
颟	mweuia
膻	dcoeia
畀	beeuii
呦	kjaaau
辏	cieeee
锛	breuei
蚬	xeiaua
蟥	heeiia
叟	shaooo
嘞	ljeiau
跏	jjauia
妣	bneaua
捯	dueaii
瓴	lheaoo
塄	lniaoe
圊	qeeeia
遴	lgoaoo
溲	stuiao
垆	lnieae
辇	noeaii
菏	hwooei
睢	seuioe
狺	kkoeee
藿	hweoui
搠	suouua
狯	ykuoee
觋	xyiaua
荻	dwuaou
铟	kriaeu
鹮	heuaee
瘕	jfaeae
秣	mleeoo
盱	xeeeii
珪	goeiei
牝	pluaaa
檗	bbeioo
痍	kfeaoo
遑	hhoaoo
垸	hnooee
蒌	lwouau
柁	dbooua
徂	cmiaee
佰	bheuia
巽	xbeiuo
醪	lyaouo
薨	hweuua
稹	vleiuo
奭	speueu
衲	ndiaoo
瑗	kouoee
蚧	jeuoui
炜	wgeeii
焯	cgieia
猗	kkeuei
腘	gciaee
赉	luiauo
砬	lpoeee
殁	mpuaao
峁	meuaai
庑	wfeeaa
馗	ykouui
鄄	jyaiii
蜱	peuiei
筌	qluoee
箐	jleeia
秭	zluauu
汜	staeaa
勣	joauuu
菪	dwooeu
莒	jwiaia
餍	kpuooa
粿	ggiaoo
羼	cbouou
诜	sdueua
薅	hwaueu
葶	twoeei
鹗	rjuaee
愆	qmoaoo
喱	ljeuia
嘚	djuuia
濑	lteiua
狒	fkaeii
趺	fjeeoo
芨	jwuaoo
苎	vwooee
嫱	qneiia
鼋	koiaia
氽	thiaoo
俳	phieie
玢	bouoau
樯	qbeiia
赜	zyeeia
誊	tgoeee
湎	mteuee
谌	cdeiuo
鲕	rkeuii
鬲	geiaia
牤	mloeaa
筚	bleaei
柝	tbuuoo
痧	sfooiu
墀	cnaeio
疋	pzoooo
毂	gnuaao
髂	qeooua
蕲	qwouuu
煲	bhouuo
轫	riauoo
貘	mjeiia
颢	hieuia
鸻	hmuaee
甗	kreioo
岘	xeiaua
槎	cbouei
麾	hfueaa
赀	zriauo
蘅	hwuuua
猡	lkiaua
捽	zuoeuo
朊	rceeua
墁	mniaia
暝	mioaia
瘌	lfeiii
芟	swuaao
箝	qleiei
眊	meueaa
谪	vdoeia
帑	nniaii
眬	leeuoo
拤	quieoo
燔	fguoia
夼	ypuiii
鳓	lkeiau
苈	lweuau
旰	gieeii
匚	fiaaaa
玭	poeaua
骺	heuuia
颍	kkeuia
缟	gcoeia
爻	kjuooo
鹚	cguaee
醐	hyeiua
砜	fpuauo
鼙	pnuiei
廨	xfuaau
哙	yjuoee
岣	geuaia
嵝	leouau
珥	roeiee
迓	kioaoo
锕	rraiei
猢	hkeiua
顸	hoeuia
堃	yfeiee
澧	ltiaei
砀	dpauuu
躞	xjoeao
诒	ddaoia
莜	kwuiue
峤	jeueui
荇	xwuuee
戡	yyeaoo
袷	jduoia
瘆	sfaouu
沚	vtieee
湲	ktuoeu
邙	mfaiii
醣	tyoeae
埭	dnaeoo
囟	xhuooo
蕈	xweiia
尅	yyeioo
箬	rleieu
掴	guiaee
砉	hoeuia
咴	hjeuou
罡	geeiee
耪	pooeoe
鄜	ffaiii
塆	wnoeae
豨	xpuoeu
硌	gpuaia
嬴	kfiaua
杌	wbeuaa
峄	keaoee
倥	yhooei
咭	jjeiia
醌	yyiaea
玙	koeaee
焓	hguoia
苒	rwiaee
哌	pjuuua
茑	nwuaee
嬖	bbauee
桲	bbeiai
欂	bbeioo
岊	bbiaii
棓	bboeia
屄	bboouo
栟	bbouee
枹	bbuaae
杓	bbuaoo
擘	bbueii
椑	bbuiei
鐾	bbuoee
朳	bbuooo
骉	bcaaaa
纰	bceaua
脿	bceeua
胈	bceuao
缏	bcuiei
邲	bdaiii
袯	bdauao
诐	bdauao
褊	bdoaia
祊	bdoeuu
蚆	beaiaa
岜	beaiaa
幖	beeiee
蛃	beeioo
豳	beeueu
赑	beiaia
髌	beooui
蝂	beuiuu
嶓	beuoia
瓿	bfeaoo
癍	bfeeoe
瘭	bfeiee
庳	bfuiei
羓	bgaiaa
熛	bgeiee
糒	bgeieu
煸	bgoaia
魃	bheuao
倴	bheuei
佖	bhoaoo
儦	bhoeoo
傧	bhooui
鹎	bhuaee
昪	biaoeu
坒	bieiee
晡	bieioo
昺	bieioo
昄	biuuao
跸	bjeaei
咇	bjoaoo
踣	bjoeia
趵	bjuaoo
攽	bjueoo
勹	bkaaaa
鲃	bkaiaa
狴	bkeaei
鲾	bkeiae
鲅	bkeuao
鲌	bkuiee
笾	blauoa
馞	bleiai
馛	bleuao
箅	bliaeu
馝	bloaoo
幷	blueii
犇	blueue
舭	bmeaua
甏	bneaoo
妭	bneuao
埗	bnieiu
塝	bnoeoe
堋	bnuaua
坋	bnuoau
琫	boeeee
玤	boeeii
邫	boiaai
琲	boieee
珌	booaoo
砵	bpeiee
皕	bpeuia
碥	bpoaia
觱	bpuaua
磻	bpuoia
邶	braiii
镈	breiei
钸	breuia
镚	briaua
镔	brooui
龅	bruaae
铇	bruaae
钣	bruuao
忭	bsoeoo
窆	bsuooo
沘	bteaua
浡	bteiai
灞	bteoei
瀌	btoeoo
湴	btouei
滗	btueue
濞	btuiia
摽	bueiee
捌	buiaii
搒	buoeoe
抃	buoeoo
薜	bwaeoe
荜	bweaei
蔈	bweiee
菝	bweieu
茇	bweuao
萹	bwoaia
苾	bwoaoo
蔀	bwoeai
蒡	bwoeoe
藨	bwoeoo
萆	bwuiei
邴	byaiii
鞁	byauao
鞴	byeiui
醭	byiiou
靽	byouii
鹁	byuaee
髟	byuuuu
阊	caiaia
弨	cbauia
楱	cbeeee
梼	cbeeei
楮	cbeiia
樗	cbeoee
梣	cbiauo
榇	cboeei
榱	cboeia
檫	cbooua
椆	cbuaei
枨	cbueoo
梴	cbuiao
棽	cbuooa
枞	cbuouo
巛	ccaaaa
骣	ccaeai
骖	ccaoeu
肫	cceaaa
	cceeoo
綝	cceiei
缞	ccoeia
膪	ccoeia
朐	ccuaia
胣	ccueai
骢	ccuioa
脞	ccuoei
肜	ccuuuu
裎	cdiaee
襜	cduaoe
蛏	ceaoei
黪	ceaoeu
眙	ceaoia
帱	ceeeei
蝽	ceeeia
畤	ceeiei
嵖	ceeiia
瞋	ceeiia
圌	ceiaeu
遄	ceoaoo
辿	ceoaoo
螭	ceoeia
嵯	ceouei
嶒	ceouia
眵	ceuaua
瘳	cfaouo
瘛	cfeeoa
庱	cfeiuo
麤	cfoeoe
瘥	cfouei
疢	cfouoo
粢	cfouoo
犨	cfueii
痤	cfuoei
冁	cgaeei
煁	cgeiuo
歘	cguauo
俦	cheeei
俶	chiaao
偲	chiaoa
雠	choaui
隹	choeee
魑	choeia
佽	choeua
侘	chooue
鸧	chuaee
傺	chuaee
儳	chuaua
倕	chueee
伥	chueoo
偁	chuoia
邨	ciaiii
晟	cieuoo
旵	ciiaii
蹅	cjeiia
瓻	cjeioo
嘬	cjiaei
汆	cjiaoo
肏	cjiauo
踔	cjieia
跐	cjieua
噇	cjoeia
躔	cjoeia
鬯	cjuaaa
趻	cjuooa
	ckeeia
猹	ckeiia
馇	ckeiia
鲿	ckioee
酂	claiii
	claouu
毳	clueue
篪	cluuie
舡	cmeiee
艚	cmeiia
斶	cmiaua
彳	cmiiii
艟	cmoeia
媸	cnaiia
堾	cneeia
赪	cnieia
埫	cnioia
垞	cnooue
婵	cnouia
坻	cnuaoo
坼	cnuuoo
玚	coauuu
瑃	coeeia
漦	coeuia
珹	coeuoo
珵	coiaee
玼	coieua
亍	coiiii
刬	coiiii
耖	coiuuu
珫	cooeua
瑳	coouei
璁	couioa
砗	cpeaii
礤	cpeiua
殂	cpiaee
镡	creiia
铖	creuoo
锠	criaia
觇	criaua
逴	croaoo
镩	crooia
镲	crooua
鹾	crouei
龀	cruaaa
镵	cruaua
锸	crueee
惙	csaoao
憕	csaoei
怊	csauia
憷	cseiai
宬	cseuoo
悰	csooee
	csuaae
濋	cteiai
漴	ctiaoo
澂	ctiaue
漼	ctiaui
泚	ctieua
澶	ctoeia
瀍	ctoeia
浐	ctoeuu
摏	cueeui
摴	cueoee
摛	cuoeia
搋	cuuuie
茝	cweaii
莿	cweiii
蒇	cweuia
牚	cwiaea
苴	cwiaee
茈	cwieua
茺	cwoeua
蔟	cwoeue
苌	cwueoo
莝	cwuoei
苁	cwuouo
翀	cxiaii
豉	cyeiao
酲	cyiaee
韂	cyuaoe
酢	cyueee
蚩	cziaoo
厾	daeiao
椟	dbeiao
杕	dbeuoo
绐	dcaoia
绖	dceaei
胨	dceaoo
缍	dcueee
裰	ddaoao
楪	ddeaei
扂	ddieia
谠	ddioua
禘	ddoeia
祋	dduaao
嶝	deaoei
岽	deeaoo
耑	deeuii
髑	deiaua
亶	dfiaee
遆	dfoaoo
憝	dfoaoo
亸	dfouia
瘅	dfouia
炟	dgiaee
羝	dguaoo
髢	dhaiaa
垈	dheiee
俤	dhouae
儋	dhuaoe
戥	dieaoo
轪	dieuoo
鸫	diuaee
昳	diueoo
咥	djeaei
踶	djiaei
蹢	djoeia
蹾	djoeua
籴	djouoo
饳	dkaiii
鱽	dkauuu
饾	dkeiae
鲽	dkeiei
饤	dkeiii
氐	dkoooo
簦	dlaoei
簟	dleiia
笪	dliaee
筜	dlioae
舠	dmauuu
瓞	dmueoo
垤	dneaei
垯	dneuoa
妲	dniaee
垌	dniaei
坫	dnieia
垱	dnioae
媂	dnoeia
埵	dnueee
塅	dnuiua
叇	doaeoa
璒	doaoei
玎	doeiii
纛	doiaua
珰	doioae
琔	doooei
玓	douaoo
瑖	douiua
砘	dpeaaa
磹	dpeiia
硐	dpiaei
礅	dpoeue
殚	dpouia
镫	draoei
锝	driaee
铞	driaia
镝	droeia
镦	droeue
钭	drooei
铥	drueao
铫	druoau
忉	dsauuu
窎	dsuaee
憺	dsuaoe
汈	dtaeee
凼	dtaiii
溚	dteiuo
沲	dtueai
扽	dueaaa
揲	dueiei
芏	dweiee
荙	dweuoa
萣	dwooei
萏	dwuaui
菂	dwuiua
剟	dxiiii
怼	dxoaoo
耋	dyeaei
耵	dyeiii
聃	dyiaee
鞮	dyiaei
觌	dyiaua
疍	dziaee
阽	dzieia
隳	dzuoio
榑	fbeiei
枋	fboeuu
艴	fbuaai
桴	fbuoai
棼	fbuoau
绋	fcaeii
朏	fcaiii
绂	fceuao
祓	fdeuao
赙	feeiei
崶	feeiei
赗	feiaia
幞	feiiou
蚄	feoeuu
蜉	feuoai
邡	ffaiii
垡	fheiee
偾	fheiia
鼢	fhuoau
昉	fioeuu
郛	fjaiii
呒	fjeeaa
唪	fjeeee
趽	fjoeuu
蹯	fjuoia
鲼	fkeiia
鲱	fkieie
鳆	fkueia
鲋	fkuiei
篚	fleaie
簠	fleiia
馡	flieie
缶	fliiii
牥	floeuu
馚	fluoau
堼	fneiee
墦	fnuoia
酆	foaiii
邞	foaiii
玞	foeeoo
韨	foeuao
琈	fouoai
砩	fpaeii
砆	fpeeoo
豮	fpeiia
黼	fqeioo
黻	fqeuao
镄	fraeia
棐	freioo
剕	friiii
怫	fsaeii
宓	fsoaoo
氾	ftaaaa
瀵	ftouia
淝	ftuaai
浲	ftuaee
沨	ftuauo
洑	ftuieu
滏	ftuoee
葑	fweiei
棻	fweioo
芣	fweuoo
菔	fwuaai
莩	fwuoai
翂	fxuoau
覅	fyuauu
	gbeiuo
桄	gbioua
夬	gboooo
栝	gbueia
槔	gbuieu
绠	gceioo
绲	gciaea
纥	gcueaa
缑	gcuiae
诖	gdeiei
祼	gdiaoo
袼	gduaia
乢	geaaaa
眭	geeiei
罟	geeiia
崓	geiaei
蜾	geiaoo
刿	geiiii
崞	geoeai
虼	geueaa
嶲	geuiia
庋	gfeiao
疳	gfeiee
冮	gfeiee
鹒	gfuaee
廆	gfuiao
馘	ggeaia
爟	ggeiui
羖	gguaao
郐	ghaiii
仡	ghueaa
匦	gieaua
晐	gioeoo
晷	giuaia
哏	gjaeoo
趹	gjaeoo
咁	gjeiee
唝	gjeiia
呙	gjiaoo
鲄	gkeiia
鲠	gkeioo
鳡	gkeuoa
馉	gkiaia
猓	gkiaoo
馃	gkiaoo
觥	gkioua
鲧	gkuaiu
鳤	gkueoo
雊	gkuioo
觚	gkuuoo
簋	glaeia
郜	glaiii
筀	gleiei
筻	gleioo
筦	glooee
牿	glueia
筶	glueia
毌	gmeeee
舸	gmeiia
邽	gnaiii
戤	gneaoo
塥	gneiae
堌	gneiei
哿	gneiia
堽	gniaei
垙	gniouo
尕	gniuoo
妫	gnouoo
姽	gnuaaa
彀	gnuaao
榖	gnuaao
姤	gnuuia
坬	gnuuoo
鬶	goeiai
瓘	goeiia
觏	goiaua
珖	goiouo
遘	gooaoo
琯	goooae
矸	gpeeii
矼	gpeiee
廾	gpiiii
钆	graaaa
铦	grueia
宄	gsuaaa
澉	gtaeue
滆	gteiae
浭	gteioo
瀔	gteiua
尜	gteuiu
洸	gtiouo
涫	gtooia
氿	gtuaaa
淦	gtuoee
搿	guuoue
茛	gwaeoo
菰	gwaiuu
蓇	gwiaia
蒄	gwoaee
荄	gwoeoo
嘏	gyaeae
鞲	gyeeia
酤	gyeiia
耇	gyuaia
陔	gzoeoo
阍	hauaia
橞	hbeioa
彟	hbeiui
槲	hbuaoo
桁	hbuuee
纮	hceuao
缳	hciaei
缋	hciaia
胲	hcoeoo
綄	hcooii
绗	hcuuee
袆	hdeeii
戽	hdooei
隺	hdoooo
崡	heaiai
翙	heaoao
虷	heeeii
峘	heeiae
岵	heeiia
蟪	heeioa
嵅	heeuia
蚝	heueaa
鄗	hfaiii
冱	hfeaee
癀	hfeiia
颃	hfeuia
瘊	hfuiae
邩	hgaiii
煳	hgeiua
烠	hgeuia
熇	hgoeia
糇	hguiae
烀	hguoii
侴	hhaiii
郃	hhaiii
佸	hhueia
皞	hhuieu
暵	hieiia
昈	hioauu
鹖	hiuaee
曷	hiuauo
昒	hiuauu
轷	hiuoii
咍	hjaoia
貆	hjeiae
嚆	hjeioe
嚄	hjeiui
谼	hjeiuo
哕	hjiaua
	hjoiae
吽	hjueii
喤	hjuiee
郇	hkaiii
觟	hkeiei
鹱	hkeiui
鳠	hkeiui
鲩	hkooee
鳇	hkuiee
饸	hkuoia
鲘	hkuuia
盉	hliaee
笏	hluauu
馠	hluoia
後	hmaaua
郈	hmaiii
垕	hmiaei
艎	hmuiee
姮	hneiae
婳	hneiae
婫	hniaea
垾	hniaee
盍	hniaee
嬛	hniaei
嫭	hnieuo
恚	hnoaoo
觳	hnuaao
縠	hnuaao
垎	hnuaia
堠	hnuiae
媓	hnuiee
邗	hoaiii
玒	hoeiee
瑝	houiee
耠	houoia
琀	houoia
翃	hpaoao
硔	hpeiuo
虺	hpiaoo
虍	hreaaa
镮	hriaei
钬	hrouuo
锪	hruaoa
龁	hrueaa
锽	hruiee
锾	hruoee
铪	hruoia
黉	hseiia
怙	hseiia
逭	hsoaoo
鲎	hsuaee
惛	hsuaia
濩	hteiui
淏	htiaee
溷	htiaeu
灏	htiaeu
澴	htiaia
滉	htiaio
漶	htiaoa
漷	htoeai
淴	htuaoa
澔	htuiue
浍	htuoee
浛	htuoia
撖	huaeue
扞	hueeii
攉	hueoui
擐	huiaei
荭	hwaaei
荁	hweiae
蕻	hweiei
劐	hwiiii
蔊	hwouia
芴	hwuauu
萑	hwuioe
翚	hxoaea
翯	hxoeia
乤	hyaaaa
醢	hyeuia
鞨	hyiaua
阄	jauaia
楗	jbaeao
叚	jbaeao
椐	jbaeei
弪	jbaoei
彐	jbeeee
枅	jbeeii
堲	jbeiee
槚	jbeiia
槿	jbeiia
枧	jbiaua
弶	jboeia
檞	jbuaau
屦	jbuuou
乣	jcaaaa
腒	jcaeei
膙	jcaeia
肼	jceeii
糸	jciuoo
祲	jdaeao
皲	jdauao
讵	jdeaae
扃	jdiaia
褯	jdoeia
裥	jdoiia
谫	jdouau
衿	jduooa
崌	jeaeei
赆	jeaeoo
畯	jeaouo
岠	jeeaae
蜐	jeeiau
豇	jeeiee
	jeeuaa
罽	jeeuou
岨	jeiaee
峧	jeoeuo
虮	jeuaaa
雎	jeuioe
囧	jeuoia
冏	jeuoia
骱	jeuoui
廑	jfeiia
齑	jfieee
麖	jfoeia
竫	jfuaae
	jfuaee
焗	jgaeai
糨	jgaeia
焌	jgaouo
桊	jgeioo
焆	jgiaia
鹣	jguaee
鹡	jguaee
燋	jguioo
爝	jguoae
鼱	jheeia
佶	jheiia
傕	jhoaoe
僦	jhoeeu
鹪	jhuaee
伋	jhuaoo
牮	jhueii
敫	jhueoo
僬	jhuioo
皦	jhuiue
皭	jhuoae
晙	jiaouo
暕	jieioo
踺	jjaeao
跽	jjaeoa
喈	jjeaui
趼	jjeeii
戢	jjeioo
哜	jjoeui
斝	jjooei
蹐	jjouia
噍	jjuioo
鱾	jkaeaa
鲪	jkaeia
觖	jkaeoo
邭	jkaiii
馂	jkaouo
鲒	jkeiia
觭	jkeuei
狷	jkiaia
玃	jkiaui
猄	jkoeia
鳉	jkoeua
獍	jkoeua
鲚	jkoeui
鳒	jkouoo
秬	jleaae
笄	jleeii
筥	jliaia
笕	jliaua
犋	jliauo
穄	jluaee
篯	jlueee
徛	jmeuei
徼	jmuiue
弆	jnaoeu
劼	jnauuu
婧	jneeia
娵	jneiao
墐	jneiia
姞	jneiia
坰	jniaia
垍	jnuiee
妗	jnuooa
琚	joaeei
珺	joaeia
珒	joaeii
玦	joaeoo
耩	joeeia
琎	joeeoa
瑨	joeiia
耤	joeiia
璥	joeiue
靓	joiaua
恝	jooaoo
戋	jooooo
	jouaee
玖	jouaoo
璬	jouiue
玠	jououi
砄	jpaeoo
殛	jpaiee
礓	jpeiae
殣	jpeiia
砠	jpiaee
丌	jpiiii
劂	jpiiii
剞	jpiiii
乩	jraaaa
锔	jraeai
鐍	jraoia
铗	jreooo
锩	jrouaa
悈	jseaeu
蹇	jsiaie
窭	jsouau
浕	jtaeoo
泇	jtauia
湝	jteaia
汫	jteeii
瀱	jteieu
溍	jteiia
漖	jteiue
泂	jtiaia
澽	jtieeu
滘	jtoaei
湔	jtouia
洚	jtuaea
漈	jtuaee
泃	jtuaia
洎	jtuiee
捃	juaeia
郏	juaiii
掎	jueuei
搛	juouoo
挢	juueui
葭	jwaeae
莙	jwaeia
荩	jwaeoo
芰	jweiao
蕺	jwiaei
藠	jwiaia
蒟	jwoeua
茳	jwooei
斠	jwooei
菅	jwooia
蒹	jwouoo
艽	jwuaaa
葰	jwuiao
矞	jxiauo
刭	jxiiii
鞬	jyaeao
戬	jyeaoo
靬	jyeeii
墼	jyeiee
鞯	jyeieu
碁	jyeuia
堇	jyiaee
赍	jyiauo
醵	jyieeu
惎	jyoaoo
鞫	jyuaoe
鬏	jyueou
卺	jzaaaa
闫	kaeeee
訚	kaoeia
棫	kbeaia
杙	kbeaoo
樾	kbeiea
槱	kbeioo
橒	kbeoee
栐	kboaoo
椸	kboeue
棪	kbouou
枍	kbuoea
渰	kbuoeu
骃	kciaeu
缊	kciaia
刖	kciiii
祎	kdeeii
禋	kdeiei
谳	kdeieu
扆	kdoeoo
扊	kdouou
扅	kduaua
褕	kduoia
觃	keaiee
峣	keeaeu
蝘	keeaia
蜮	keeaia
岈	keeauu
崾	keeiau
蟫	keeiia
圉	keeiou
睚	keeuei
罨	keeuia
颙	keeuia
顗	keeuia
崦	keeuia
蜎	keiaia
髃	keiaoo
嵎	keiaoo
蝣	keoeue
螠	keouia
蛘	keouii
嶷	keuaao
鹝	keuaee
黟	keuaua
崟	keuoee
嵛	keuoia
蝓	keuoia
鄘	kfaiii
翊	kfaoao
痖	kfeiee
瘗	kfeoei
裛	kfiaai
廙	kfiaei
赟	kfiauo
麀	kfuaaa
庾	kfuioo
瘐	kfuioo
饔	kfuooa
燏	kgaoia
羱	kgeuui
煴	kgiaia
羕	kgoaoo
烊	kgouee
燚	kgouou
鹢	kguaee
羑	kguaoo
烻	kguiao
烨	kguiei
燠	kguieu
爚	kguoia
鄅	khaiii
佁	khaoia
倻	kheiai
侑	kheuia
舁	kheuii
弇	kheuii
俣	khiaee
龠	khiaia
劓	khiiii
悆	khoaoo
佾	khuoia
繄	kiaaiu
匜	kiaiaa
郾	kiaiii
轺	kiauia
旸	kiauuu
昱	kioeee
昀	kiuaoe
嚚	kjeaia
咉	kjiaoo
乂	kjoooo
鹆	kjuaee
卬	kkaiii
鲬	kkaoia
饴	kkaoia
狁	kkaoua
飏	kkauuu
猰	kkeeeu
馌	kkeiia
鲉	kkiaee
眢	kkiaee
夤	kkooei
	kkuaai
饫	kkueoo
狳	kkuoee
猺	kkuoue
鳐	kkuoue
筼	kliaia
籥	kliaia
馧	kliaia
箢	klooua
簃	klueua
舣	kmouoo
艅	kmuoee
圯	knaeaa
埇	knaoia
妤	knaoii
嫕	kneaoa
妘	kneeao
墕	kneiea
垚	kneiei
堙	kneiei
媖	kneiia
嬿	kneiie
堐	kneuei
嫄	kneuui
埸	kniaua
墉	knoeae
堉	knoeia
垟	knouee
圫	knueaa
鋆	knuoee
媱	knuoue
珢	koaeoo
邘	koaiii
邧	koaiii
玡	koeauu
耰	koeuua
玥	kouaee
瑀	kouioo
尢	kpaaaa
砑	kpeauu
殪	kpeiei
厣	kpiaii
黡	kpiaoo
钇	kraaaa
钖	krauuu
铘	kreaai
铔	kreiee
锳	kreiia
铕	kreuia
卣	kriaae
虤	krieua
镛	kroeae
镱	kroeoa
镒	krouia
龂	kruuii
宧	kseaia
戭	kseaoo
宥	kseuia
窅	ksiaee
愔	ksoeia
窬	ksuoia
窳	ksuuuu
滪	ktaoeu
潏	ktaoia
沇	ktaouo
沄	kteeao
潆	kteiaa
漹	kteiea
溁	kteiei
澐	kteoee
浥	ktiaai
潩	ktiaei
洇	ktiaeu
涢	ktiaia
澭	ktoeaa
淯	ktoeia
滧	ktoeue
洢	ktuiae
浟	ktuiue
瀹	ktuoia
溵	ktuuua
掾	kuaaeu
揠	kueaia
雩	kueeaa
挹	kuiaai
撄	kuiaau
慭	kuoaoo
霪	kuoouo
蓣	kwaoeu
芫	kweeua
薳	kweioa
薏	kwoeoa
菸	kwoeuo
蕰	kwooia
茚	kwuaai
莸	kwuaeu
薁	kwuieu
萸	kwuioo
蓥	kwuoee
遹	kxoaoo
靿	kyaaua
酏	kyaiaa
鄢	kyaiii
勚	kyuaaa
歅	kyuauo
敔	kyueoo
隃	kzuoia
〇	laaaaa
栳	lbeiua
檑	lbeoia
梾	lbeooo
枥	lbeuau
橑	lbeuia
梠	lbiaia
椤	lbiaua
栌	lbieae
桹	lboaoo
逯	lboaoo
椋	lboeiu
朸	lbuaaa
柃	lbuooa
缧	lciaaa
脶	lciaia
缡	lcoeia
臁	lcoeou
膦	lcouua
骝	lcuaia
脟	lcuoei
诔	ldeeoo
塱	ldeiee
祾	ldeiuo
襕	ldoiei
袊	lduooa
裣	lduooo
郦	leaiii
疁	leaouo
髎	leaouo
罱	leeiia
蝲	leeiii
崚	leeiuo
峛	leeuii
剅	leiiii
崀	leoaoo
詈	leoeee
蠊	leoeou
	leouau
瞵	leouua
罶	leuaia
罍	leueii
圙	leuoeu
癃	lfaiua
娈	lfauee
凓	lfeiei
癗	lfeoia
膂	lfiaee
蠃	lfiaua
脔	lfiauo
旒	lfueoe
翷	lgaoao
粝	lgeuea
烺	lgoaoo
熘	lguaia
僇	lhaouo
魉	lheioo
俫	lheooo
俍	lhoaoo
倞	lhoeia
鸰	lhuaee
昽	lieuoo
辌	lioeia
辚	liouua
辂	liuaia
轹	liuaoo
昤	liuooa
躐	ljaaia
叻	ljauuu
哢	ljeeeu
呖	ljeuau
蹽	ljeuia
跞	ljuaoo
鲡	lkeiao
鳢	lkiaei
鹠	lkuaee
饹	lkuaia
飗	lkuaia
雒	lkuioe
箖	lleiei
篥	lleiei
稑	lleiuo
簝	lleuia
稆	lliaia
稂	lloaoo
筤	lloaoo
簏	lloeea
氇	lluaia
簕	llyiau
舻	lmieae
甪	lmiiii
舲	lmuooa
垏	lnaeii
嫪	lnaouo
堎	lneiuo
坜	lneuau
嫽	lneuia
嫘	lniaaa
埌	lnoaoo
墚	lnooei
埒	lnuoei
姈	lnuooa
坽	lnuooa
琭	loaeio
珋	loauai
珕	loauau
琏	loeaoa
耢	loeiau
瑓	loeioo
嫠	loeuau
釐	loeuia
	lpeeoo
礌	lpeoia
砳	lpeuia
尨	lpoooo
磏	lpouoo
鹩	lpuaee
	lpuaee
尥	lpuaoo
镴	lraaia
钌	lraiii
铹	lreiau
铑	lreiua
铼	lreooo
镙	lriaaa
锒	lroaoo
锍	lroeui
鸬	lruaee
镥	lruaia
镏	lruaia
锊	lruoei
憭	lseuia
悢	lsoaoo
懔	lsoeee
渌	ltaeio
泐	ltaiau
漋	ltaiua
漻	ltaouo
瑬	lteeoo
漤	lteiau
澪	lteouo
洌	lteuii
泷	lteuoo
漯	ltiaaa
浬	ltiaee
溇	ltouau
潾	ltouua
澛	ltuaia
泺	ltuaoo
浰	ltueii
鎏	ltuoee
泠	ltuooa
酃	luaiii
捩	luoaeu
菉	lwaeio
菻	lweiei
荖	lweiua
藟	lwiaia
蕗	lwiaua
蓢	lwoaua
蓠	lwoeia
蒗	lwoooa
荦	lwueii
莶	lwuooo
蔹	lwuoue
葎	lwuuae
蓏	lwuuuu
勠	lxauuu
鹨	lxuaee
鞡	lyeioe
醨	lyoeia
酹	lyuoei
杩	mbaaee
楙	mbaoei
杪	mbiuuu
愍	mboaoo
杧	mboeaa
缗	mcaeia
祃	mdaaee
祕	mdoaoo
祢	mduaiu
蛑	meaoue
眄	meeiaa
幪	meeiee
蠛	meeiia
眇	meiuuu
瞇	meouoa
瘼	mfeiia
忞	mfoaoo
麽	mfuaoo
旄	mfueue
熳	mgiaia
敉	mgueoo
侔	mhaoue
偭	mheuia
仫	mhuaoo
劢	miauuu
旻	mioeoo
唛	mjeeua
喵	mjeiia
貊	mjeuia
黾	mjiaaa
猸	mkaiia
獴	mkeiee
獏	mkeiia
毪	mlaoue
牻	mleuoo
鳘	mluaee
艋	mmaiia
艨	mmeiee
坶	mnaaoo
嫫	mneiia
嫚	mniaia
嬷	mnoeua
媄	mnoueu
珉	moaeaa
瑂	moaiia
耱	mooeeu
玟	mooeoo
勔	mpauuu
礞	mpeiee
硭	mpeioe
厖	mpeuoo
碈	mpuaia
镅	mraiia
芈	mreeii
镆	mreiia
镘	mriaia
钔	mroiaa
愐	mseuia
湣	mtaeia
漭	mteieu
渑	mtiaia
渼	mtoueu
洣	mtouoo
泖	mtuaai
浼	mtuaia
洺	mtuaia
苠	mwaeaa
鄚	mwaiii
荬	mwaooe
甍	mweaao
瞢	mwiaee
蓂	mwiaoe
蘼	mwoeie
藦	mwoeue
茆	mwuaai
鹋	mwuaee
鹲	mwuaee
芼	mwueaa
瞀	mxiaee
蟊	mxiaia
蝥	mxiaoo
鍪	mxuoee
丏	myaaaa
靺	myeeoo
鬘	myiaia
醾	myoeou
鞔	myuaia
耄	myueaa
郿	mzaiii
鹛	mzuaee
杻	nbaiee
柰	nbeeiu
柟	nbiaee
腩	nceiia
臑	nceoeu
肭	nciaoo
嬲	neauia
蛲	neeaeu
蝻	neeiia
嵲	neuiei
麑	nfuiuo
伲	nhaeua
佴	nheiee
齉	nheiia
臬	nheioo
傉	nheuei
曩	nioeia
狃	nkaiee
峱	nkaiia
猱	nkaoei
馕	nkeiia
猊	nkuiua
馜	nlaeua
笯	nlauao
秾	nloaoo
驽	nnaaee
坭	nnaeua
孥	nnaiee
婻	nneiou
砮	nneuia
鼐	nniaae
胬	nniauo
垴	nnoeuo
妳	nnuaiu
耨	noeuei
恧	npoaoo
硇	npuiuo
钕	nrauee
锘	nreieu
镎	nruoue
甯	nsoaia
攮	nueiia
萳	nweiou
薿	nwuaao
糵	nwuiou
菍	nwuooa
聍	nyooei
乸	nzaaoo
陧	nziaei
甓	pbeaoo
枰	pbeoii
榀	pbiaia
	pboeua
椪	pbouei
弸	pbuaua
楩	pbuiei
脬	pcuoai
襻	pdeieu
谝	pdoaia
蚍	peeaua
螵	peeiee
罴	peeioo
蟛	peeiuu
蚲	peeoii
帡	peouee
庀	pfuaaa
旆	pfueei
裒	pfuiua
郫	phaiii
仳	pheaua
伾	pheuee
衃	pheuoo
俜	phiaea
皤	phuoia
哱	pjeiai
鲏	pkauao
鲆	pkeoii
狉	pkeuee
逄	pkoaoo
鳑	pkoeoe
筢	pleiai
穙	pliiou
犏	ploaia
氆	plouia
簰	pluiui
氕	pluuuu
舥	pmaiaa
嚭	pneuia
娉	pniaea
墣	pniiou
埤	pnuiei
垺	pnuoai
玶	poeoii
珮	pouaei
匏	ppuaae
殍	ppuoai
攴	praooo
	prauoo
钷	preaia
镤	priiou
锫	proeia
镨	prouia
澼	ptaeoe
潖	pteeai
泙	pteoii
涄	ptiaea
淠	ptiaeu
洴	ptouee
潽	ptouia
淜	ptuaua
湓	ptuoia
擗	puaeoe
雱	pueauu
拋	pueuau
抔	pueuoo
掊	puoeia
霈	puooei
芘	pweaua
苉	pweauo
蒱	pweiei
苤	pweuee
薸	pwooei
蓱	pwooou
蒎	pwoouu
荓	pwouee
芃	pwuaoo
酦	pyauoo
酺	pyeioo
醅	pyoeia
陴	pzuiei
邔	qbaiii
棤	qbeiia
桤	qbiaae
棬	qbouaa
杄	qbueii
檎	qbuooe
骎	qcaeao
胠	qceiao
骐	qceiuo
缲	qciaei
缱	qciaoa
绻	qcouaa
肷	qcuauo
綮	qdaaiu
诎	qdaiii
袪	qdeiao
棨	qdeioo
谯	qduioo
屺	qeaeaa
岍	qeeeii
螓	qeeeue
赇	qeeioo
蜞	qeeiuo
畎	qeeuoo
睄	qeioia
黥	qeoeia
蜣	qeouee
蝤	qeouei
氍	qeueaa
囷	qeueoo
嵚	qeueua
勍	qfauuu
庼	qfeaeu
竘	qfuaia
糗	qguieu
炝	qguoaa
癿	qhaaaa
俅	qheioo
伣	qhiaua
劁	qhiiii
鼽	qhuaaa
鼩	qhuaia
仟	qhueii
佺	qhuoee
椠	qieioo
辁	qiuoee
郄	qjaiii
跂	qjeiao
踦	qjeuei
吣	qjoaoo
劬	qkauuu
鲭	qkeeia
鲯	qkeiuo
訄	qkoeia
犰	qkuaaa
鹐	qkuaee
鸲	qkuaee
鳈	qkuiia
筇	qleiai
墘	qneiue
埼	qneuei
婍	qneuei
坥	qniaee
悫	qnoaoo
婘	qnouaa
埆	qnuaua
圲	qnueii
玘	qoaeaa
璆	qoaouo
璩	qoieeu
麹	qouaou
瑔	qouiia
亓	qouiii
玱	qouoaa
硗	qpeaeu
碶	qpeeeu
碃	qpeeia
碏	qpeiia
磲	qpooei
磜	qpuaee
硚	qpueuo
锓	qraeao
镪	qraeia
锖	qreeia
锜	qreuei
悛	qsaouo
慬	qseiia
愭	qseiia
悭	qsiiei
褰	qsoeoo
慊	qsouoo
搴	qsueii
愀	qsueou
汧	qteeii
溱	qteeue
柒	qteioo
呇	qtiaee
灈	qtiaui
汔	qtueaa
芑	qwaeaa
蔃	qwaeia
葜	qweeeu
檠	qweioo
萁	qweiuo
苘	qwiaia
蘧	qwieoa
	qwooau
蕖	qwooei
鹙	qwuaee
芡	qwuauo
芊	qwueii
萩	qwueou
蒨	qwuiee
郪	qyaiii
跫	qyiaie
蛩	qyiaoo
逑	qyoaoo
謦	qyoeee
鬈	qyouaa
鞧	qyouei
麴	qyuaou
鞒	qyueui
銎	qyuoee
枘	rbiaoo
驲	rciaee
纴	rcueee
诶	rdaoue
讱	rdauoo
峎	reaeoo
峏	reeuia
崿	reiaee
蚺	reiaee
蚋	reiaoo
闇	reoeia
廒	rfeeue
盦	rhoaei
儴	rhoeia
豻	rjeeii
咡	rjeiee
唵	rjeuia
嗌	rjouia
吖	rjouii
狨	rkeaeu
邚	rnaiii
婼	rneieu
嬬	rneoeu
媆	rneueu
堧	rneueu
埯	rneuia
堨	rniaua
垵	rnooau
嫒	rnuoeu
姶	rnuoia
毐	roaauu
璈	roeeue
聱	roeiee
瓀	roeoeu
獒	roeuoo
嶅	roiaii
瑢	rooouo
叆	rouoeu
砹	rpeiuo
奀	rpeuoo
奡	rpiaeu
鸸	rpuaee
耏	rpuuuu
铒	rreiee
锿	rroeia
锇	rrueoo
洳	rtauia
溽	rteuei
汭	rtiaoo
瀼	rtoeia
涐	rtueoo
颥	rueuia
揞	ruoeia
挼	ruuoau
蒻	rwaeae
鄀	rwaiii
荛	rweaeu
爇	rweioo
葚	rweiuo
薷	rweoeu
苊	rweuaa
蓐	rweuei
蕤	rweuue
蘘	rwoeia
莪	rwueoo
欸	rxuaoo
艹	ryiiii
鞥	ryuoeu
陑	rzeuia
隩	rzuieu
柖	sbauia
栻	sbeaei
椹	sbeiuo
楒	sbiaoa
桫	sbooiu
鹔	sbuaee
鸤	sbuaee
榫	sbuiei
楯	sbuuei
骕	scaeoo
骦	sceoei
腨	sciaeu
胂	sciaii
缌	sciaoa
绱	scioia
骟	scoaao
脎	scuoei
邥	sdaiii
襫	sdeueu
祏	sdeuia
谇	sdoeuo
谉	sdooia
襚	sdouoa
谂	sduooa
邖	seaiii
睃	seaouo
瞫	seeiia
崧	seeiuo
屾	seiaii
蛸	seioia
帨	seouia
蟮	seouia
兕	seuaaa
瞍	seuiao
竦	sfeioo
凘	sfeiuu
旞	sfueoa
廋	sfuiao
燊	sgeioo
槊	sgeioo
炻	sgeuia
剡	sgiiii
墡	sgouia
鄃	shaiii
傃	sheeaa
隼	sheiii
鼫	sheuia
畬	shiaee
毹	shueaa
侁	shueuo
晱	siouou
昇	siueii
哂	sjeiee
唼	sjoeau
嗾	sjoeue
蹜	sjooui
嗍	sjouua
狲	skaiiu
鲹	skaoeu
鳋	skaoia
殳	skaooo
狻	skaouo
鲺	skauia
觫	skeioo
馓	skeiue
鲥	skiaei
飔	skiaoa
鳣	skoeia
觞	skueau
飧	skuooa
笥	slaeia
矧	slaeii
筮	sleiuo
眚	sliaee
穟	slouoa
歃	sluauo
甡	slueee
虒	smieua
艏	smouui
埽	snaeia
邿	snaiii
姒	snaouo
娀	sneaeu
埘	sniaei
婌	snieao
埶	snuaoo
姝	snueoo
埏	snuiao
玿	soauia
璱	soeeoa
琡	soiaao
耜	soiaee
珅	soiaii
璲	soouoa
磉	spaoei
厍	speaii
礵	speoei
奓	spuaua
铈	sroeia
钑	sruaoo
锼	sruiao
铩	sruoei
钐	sruuuu
溞	staoia
涘	staoue
溹	steiaa
滠	steiao
洓	steioo
沭	steioo
涑	steioo
潵	steiue
澌	steiuu
湜	stiaei
濉	stiaui
浉	stiuei
渖	stooia
潲	stueio
	suaoao
摅	suieoa
掞	suouou
鹴	suuaee
蓍	sweiia
蔌	sweiua
莳	swiaei
蒐	swuiao
荽	swuoau
颡	sxeuia
厶	sxoooo
毵	sxueaa
酾	syeiao
贳	syiauo
	syuaee
靸	syuaoo
甦	syueee
陞	szueei
陎	szueoo
闼	taeuoa
阘	taiaao
弢	tbaiao
枟	tbeeao
桯	tbiaee
樘	tbioei
橦	tboeia
梃	tbueao
梌	tbuoee
骀	tcaoia
彖	tceuoo
缇	tciaei
縢	tcouaa
绨	tcouae
螣	tcouia
	tcouua
绹	tcuaue
朓	tcuoau
腯	tcuuei
褟	tdiaao
禔	tdiaei
裼	tdiaua
讬	tdueaa
祧	tduoau
螗	teoeae
疃	teoeia
蜩	teuaei
盷	teuaoe
峂	teuaoo
畋	teueoo
庹	tfaeoo
鄌	tfaiii
煺	tgaeoa
熥	tgaooa
烔	tgiaei
煓	tgiaeu
焞	tgoeai
烶	tgueao
仝	theiee
侂	thoeue
倓	thouou
侹	thueao
魋	thuioo
晪	tiiauo
慝	tioaoo
曈	tioeia
暾	tioeue
跆	tjaoia
鼗	tjeiei
鼍	tjiaaa
哃	tjiaei
嘡	tjioei
啴	tjouia
跅	tjuuoo
鲐	tkaoia
饧	tkauuu
鳎	tkiaao
鲖	tkiaei
鳀	tkiaei
猯	tkiaeu
鲦	tkuaei
饦	tkueaa
乇	tlaaaa
颋	tleuia
穜	tloeia
馟	tluoai
稌	tluoee
	tmuaee
趯	tnaiui
嬥	tnaoui
坉	tneaaa
圢	tneiii
媞	tniaei
堍	tnuaoo
瑱	toeiuo
瑅	toiaei
耥	toioia
忝	toiooo
瑭	tooeae
璮	tooeia
珽	toueao
兲	touooo
砼	tpuoei
殄	tpuouu
龆	trauia
铽	treaoa
镗	trioei
镋	trioua
铴	trooau
铊	trooua
锬	trouou
忳	tseaaa
惔	tsouou
慆	tsuoui
溻	ttiaao
沺	ttiaee
淟	ttiauo
渟	ttoeei
湉	ttooue
掭	tueeio
抟	tueeoo
擿	tuoeoa
荑	tweaoo
萚	tweiao
薹	tweiea
茼	twiaei
萜	twiaie
葖	twooeu
菼	twouou
莛	twueao
邰	txaiii
榃	txiaee
炱	txouuo
邒	tyaiii
鞳	tyeiuo
橐	tyeuei
鞜	tyiaia
黇	tyieia
酡	tyooua
髫	tyuiae
酴	tyuoee
杼	vbaoii
榰	vbeiia
梽	vbeioa
椓	vbeuoo
柷	vbiauo
槠	vboaei
棁	vbouia
柊	vbuaoo
栴	vbueua
纼	vcaeii
膣	vcooea
纻	vcooee
彘	vcueea
缒	vcuioa
骓	vcuioe
胗	vcuouu
诪	vdeeei
禛	vdeiuo
诼	vdeuoo
祉	vdieee
袩	vdieia
禚	vdouoo
鸩	vduaee
袗	vduouu
蠋	veiaua
赒	veuaei
嶦	veuaoe
鄣	vfaiii
痓	vfeaei
庤	vfeiei
疰	vfoeee
麈	vfoeee
鹯	vfuaee
瘵	vfuaee
痄	vfueee
旐	vfueuo
鲝	vguaee
僎	vhaeei
齄	vheiia
偡	vheiuo
伷	vhiaee
倬	vhieia
齇	vhieia
仉	vhuaaa
	vhuaae
郅	viaiii
晊	vieaei
轾	vieaei
轵	viiauo
晫	viieia
暲	vioeia
曌	viooei
昣	viuouu
轸	viuouu
辀	viuuoo
跱	vjeiei
哳	vjeiuu
跩	vjiauu
跓	vjoeee
吒	vjueaa
踬	vjuuei
豸	vjuuuu
橥	vkeioo
飐	vkieia
觯	vkouia
鲊	vkueee
邾	vlaiii
稙	vleiia
籀	vleiua
劄	vliiii
笊	vluuoo
卮	vmaaaa
衠	vmeiee
舳	vmiaee
舯	vmiaii
鸼	vmuaee
喆	vneiia
埴	vneiia
嫜	vnoeei
婤	vnuaei
瑑	voaaeu
瑧	voeeue
碡	vpeeaa
砫	vpoeee
詟	vpoeia
磔	vpuaei
砟	vpueee
黹	vqouoo
铚	vreaei
钲	vreiee
	vreiei
锧	vruuei
窀	vseaaa
忮	vseiao
滍	vtaioo
浞	vtiaie
浈	vtieia
溠	vtouei
汋	vtuaoo
泜	vtuaoo
洙	vtueoo
絷	vuaaiu
搌	vuaeei
揸	vueiia
揕	vueiuo
晢	vuiaee
霅	vuoeia
摭	vuoeoo
挓	vuooue
扺	vuuaaa
拃	vuueee
荮	vwaaei
蓁	vweeue
葴	vweuia
苧	vwooei
茋	vwuaoo
茱	vwueoo
茽	vwuiia
叕	vxaoao
翥	vyaoao
酎	vyeioo
鬒	vyeiuo
疐	vyiaai
髽	vyuoei
骘	vzaaee
陟	vzieiu
烝	vzoooo
闱	waeeii
阌	wauoao
榅	wbiaia
螱	wbiaoo
椀	wbooua
肟	wceeaa
腽	wciaia
峿	weeiia
屼	weeuaa
峗	weuaaa
畖	weuuoo
痦	wfeiia
亹	wfiaee
焐	wgeiia
煟	wgiaia
炆	wgoeoo
偓	whaeeo
璺	wheeoo
鼯	wheiia
魍	whiaou
仵	whueii
暐	wiaiia
邷	wiaiii
辒	wiiaia
辋	wiiaou
旿	wiueii
鹟	wjuaee
踒	wjueau
鳚	wkaeei
鲔	wkeuia
鳂	wkiaea
鳁	wkiaia
迕	wloaoo
艉	wmaeue
圬	wneeaa
妧	wneeuo
婠	wnooia
珷	woeeie
珸	woeiia
琬	woooua
琟	wouioo
尪	wpeeee
硙	wpiaae
碨	wpiaea
硊	wpuaaa
硪	wpueoo
铻	wreiia
寤	wsaiei
怃	wseeaa
窊	wsuuoo
浯	wteiia
洿	wteuee
洧	wteuia
涠	wtiaee
溦	wtiaue
涴	wtooua
沩	wtouoo
洈	wtuaaa
滃	wtuoao
鋈	wtuoee
霨	wuaeei
蕹	wwoeaa
芠	wwoeoo
菀	wwooua
芄	wwuaoo
郚	wyaiii
靰	wyeuaa
軎	wyiaee
鹀	wyuaee
阢	wzeuaa
隈	wziaea
鹇	xauaee
阋	xauiua
榍	xbaeio
枵	xbiaea
柙	xbiaii
屃	xbiauo
楦	xbooei
栒	xbuaia
绁	xceiaa
缃	xceiia
绡	xcioia
骍	xcoeei
缐	xcuiia
肸	xcuoei
绤	xcuoia
禒	xdaaeu
谞	xdaiia
禊	xdeeeu
祆	xdeeoo
禤	xdiaao
诇	xdiaia
讻	xduoai
谖	xduoee
	xduuii
酅	xeaiii
翾	xeaoao
翈	xeaoao
嶍	xeaoia
勖	xeauuu
蟏	xeeiae
巇	xeieea
蟓	xeuaia
睎	xeuoeu
崤	xeuoeu
崄	xeuooo
痃	xfoeaa
庠	xfouee
庥	xfuiei
糈	xgaiia
烜	xgeiae
粞	xgeiee
煋	xgiaue
爔	xgouue
鲞	xguaee
欻	xguauo
熻	xguoao
偰	xheeeu
鸺	xheiua
儇	xhiaei
魈	xhioia
伈	xhoaoo
伭	xhoeaa
翛	xhuaao
脩	xhuaia
舄	xhuaoo
皛	xhuiui
鼷	xhuoaa
傒	xhuoaa
俙	xhuoeu
旴	xieeii
晅	xieiae
暿	xieiia
冔	xiiaee
昡	xioeaa
暶	xioeue
暅	xiooei
昫	xiuaia
曛	xiueoo
晞	xiuoeu
噀	xjaeei
郤	xjaiii
咺	xjeiae
吅	xjiaee
鸮	xjuaee
欷	xjuauo
跹	xjueoa
跣	xjueua
谿	xjuoia
邜	xkaiii
觿	xkaiui
鳛	xkaoui
夐	xkiaua
虓	xkieua
猇	xkieua
饻	xkoeoo
馐	xkouai
獬	xkuaau
狝	xkuaiu
鱻	xkuaua
饩	xkueaa
獯	xkueoo
猃	xkuooo
筅	xlueua
邤	xmaiii
媭	xmauee
舾	xmeiee
衒	xmoeee
婞	xneiou
憙	xnoaoo
垿	xnoeao
孅	xnuoie
絜	xoaaiu
珝	xoaoao
珛	xoeuia
琄	xoiaia
瑆	xoiaue
玹	xooeaa
瓖	xooeia
瑄	xoooei
珣	xouaia
琇	xoueua
珦	xouiia
硎	xpeeii
硖	xpeooo
碹	xpooei
燹	xpouuo
铏	xreeii
钘	xreeii
铉	xroeaa
恓	xseiaa
峃	xsiaii
泶	xsiaoo
恔	xsoeuo
愃	xsooei
恂	xsuaia
穸	xsuaoo
忺	xsuauo
敩	xsueoo
湑	xtaiia
涍	xteiai
渫	xteiei
泫	xtoeaa
洨	xtoeuo
潟	xtuiua
滫	xtuiua
溆	xtuoao
浠	xtuoeu
挦	xuaeei
揳	xueeeu
揎	xuooei
芎	xwaeaa
葙	xweiia
菥	xweiuu
薤	xweuie
葸	xwiaoa
茓	xwoouo
薢	xwuaau
蓰	xwuuie
枲	xxeiuo
醑	xyaiia
醯	xyoeia
髹	xyuiei
隰	xziaaa
阃	yaiaei
闶	yaoeua
栲	ybeiea
尻	ybuaaa
櫆	ybuioo
骙	ycaoee
骒	yciaoo
胩	ycieoo
纩	ycoeuu
裉	ydaeoo
诓	ydeaee
裈	ydoaea
眍	yeeauo
囗	yeeeee
蚵	yeeiia
崁	yeeiua
嵁	yeeiuo
蝰	yeeuei
圐	yeiaoe
贶	yeiaua
剀	yeiiii
崆	yeooei
蛞	yeueia
邟	yfaiii
疴	yfeiia
炣	ygeiia
煃	ygeuei
焜	ygiaea
炌	yguoui
侉	yheuee
暌	yiaoee
鹍	yiuaee
匼	yiuoia
趶	yjeeii
跬	yjeiei
趷	yjueaa
鲓	ykeiea
鲙	ykuoee
筘	yleiia
衎	ymeeee
堀	ynaeai
墈	yneiau
壸	yneiee
姱	yneuee
垲	yniaae
埪	ynooei
邼	yoaiii
硍	ypaeoo
郀	ypaiii
硁	ypaoei
刳	ypiiii
硿	ypooei
矻	ypueaa
钶	yreiia
锞	yriaoo
钪	yroeua
锎	yroiee
悝	ysiaee
悃	ysiaei
愦	ysiaia
喾	ysueia
洭	yteaee
洘	yteiea
溘	yteiia
	yuooea
芤	ywaiaa
蒈	yweaui
莰	yweiua
蒉	ywiaia
蒯	ywiiii
戣	yxeaoo
牁	yzeiia
隗	yzuiao
槜	zbuiua
缁	zcaaia
驵	zciaee
腙	zcooee
缯	zcouia
驺	zcuaae
胙	zcueee
臜	zcueia
缵	zcueia
谮	zdeaia
诹	zdeiao
虸	zeaiee
帻	zeeeia
崒	zeoeuo
嵫	zeouaa
嶟	zeouei
罾	zeouia
岞	zeueee
鬷	zeuouo
疭	zfuouo
鄫	zgaiii
倧	zhooee
僔	zhouei
昃	zieuuo
啫	zjeiia
嗞	zjouaa
噂	zjouei
躜	zjueia
唣	zjuiea
鲰	zkeiao
昝	zkiaee
鲗	zkiaii
箦	zleeia
迮	zloaoo
矰	zlouia
笫	zluauu
笮	zlueee
簉	zlueoa
舴	zmueee
趑	znoeua
趱	znueia
耔	zoaiee
珇	zoiaee
璪	zoiaei
锱	zraaia
訾	zroeee
镃	zrouaa
觜	zruaua
寁	zseaoo
怍	zsueee
慥	zsueoa
拶	zuaaua
撙	zuouei
菑	zwaaia
蕞	zwiaei
菹	zwooia
鄑	zyaiii
鄹	zyaiii
鼒	zyiaae
孖	zzaiee
陬	zzeiao
牂	zzouee
阼	zzueee
